30 100
TACCAAGGGCTGAGAACAGCTCACATTCAT|AAAGACCCCTCCACGCGAGAAGGTTAACAC
CTGGCGTCGAAGTCCTAGACGCTATAGGGA|AATTAAATATTTTATCATGCGCACAGGTCA
AGTGGAATTACCAAGGGCTGAGAACAGCTC|TAATTAATTCGCGGCCCGCTATGGGTGGAA
TGAGAACAGCTCAAATTACCAAGGGCTGAG|AGGGATCAGGTTTCAGAAAGACCCCTCCAC
ACTACGACGTAAGCGATACACAGTTCAGAA|GTTGAGTCTTGCCTCGATGGGCTGTGGAAT
TGGAATTACCAAGGGCTGAGAACAGCTCAG|GTGCATAACCTGAGTGGAATTACCAAGGGC
GAGTTGTCGTCGGCATATTCGGTGGAAGGC|CGGTAGTGAACGGGTAGTACCACCACGGAA
GTGTGGGTGGAATTACCAAGGGCTGAGAAC|GGCGTCGAAGTCCTAGACGCTATAGGGATC
ATACTACAAGTGGAATTACCAAGGGCTGAG|TACCTTGAGCCGCAGGTGTCCACGGAAACC
CCAGAATGTTTTGATTCTGGCGTCGAAGTC|TGTACGGCCACGAACTAATTAAATATTTTA
ATTCCCAGATACTACAAGTGGAATTACCAA|CAGCTCAGTACCTTGAGCCGCAGGTGTCCA
GGAAGGCAAACTTTGTCTTGTCCTAGGACT|CACGGAAATATCCTATTGACACAATGTGTT
CTACGACGTAAGCGATACACAGTTCAGAAC|TTGAGTCTTGCCTCGATGGGCTGTGGAATT
AGTGGAATTACCAAGGGCTGAGAACAGCTC|CAGTGCATAACCTGAGTGGAATTACCAAGG
TGGAATTACCAAGGGCTGAGAACAGCTCAG|CACTACTCTCCGAGTTGTCGTCGGCATATT
GTTAACACGATAGCGGCTACCGAACCTGTT|GGCCTTCAGGGGCTCGATGGAAACTCGAAA
AGATACTACAAGTGGAATTACCAAGGGCTG|AGTACCTTGAGCCGCAGGTGTCCACGGAAA
AGGGCTGAGAACAGCTCACATTCATGCTGA|CCCCTCCACGCGAGAAGGTTAACACGATAG
GTGGAATTACCAAGGGCTGAGAACAGCTCA|AGAACAGCTCAGCTCAACCAAGGGCTGAGA
AGGTTAACACGATAGCGGCTACCGAACCTG|TTGGCCTTCAGGGGCTCGATGGAAACTCGA
GGGCTATTGCGTGTAAATTTGTTCAGTGCA|CCAAGGGCTGAGAACAGCTCATTCTAGGCT
CTCATGACTAAGCTACTGCCTATTGGTACA|ACAGTTCAGAACCAGTAGCTGTACCCGTTC
AGTCCTAGACGCTATAGGGATCAGGTTTCA|TTTATCATGCGCACAGGTCAGTCCTTTGAG
CTCATGAGAACAGCTCAGCTCAACCAAGGG|CAAACTTTGTCTTGTCCTAGGACTACGACG
CAGTGCATAACCTGAGTGGAATTACCAAGG|CTAGGCTTACTTATAAGAATGGTATTCAAA
AACAGCTCAAATCTGATCGTGGAATTACCA|GGGTGGAATTACCAAGGGCTGAGAACAGCT
TAGACGCTATAGGGATCAGGTTTCAGAAAG|CATGCGCACAGGTCAGTCCTTTGAGCTACG
CTGAGAACAGCTCAGTACCTTGAGCCGCAG|GGAATTACCAAGGGCTGAGAACAGCTCAAA
GTGTAAATTTGTTCAGTGCATAACCTGAGT|AGAACAGCTCATTCTAGGCTTACTTATAAG
GAACAGCTCAAATTACCAAGGGCTGAGAAC|AGGGCTGAGAACAGCTCATGACTAAGCTAC
ACACGATAGCGGCTACCGAACCTGTTCGCG|TTCAGGGGCTCGATGGAAACTCGAAAAGAT
CAAGGGCTGAGAACAGCTCAAATTACCAAG|AGCTCAACCAAGGGCTGAGAACAGCTCATG
GTCGGCACGGGGCTATTGCGTGTAAATTTG|GTGGAATTACCAAGGGCTGAGAACAGCTCA
CATACCGATCCATGAGGACGTAGAGATACA|AGACCTAACCCACCTCTGTATCATCTGCTG
GTCATGGGATTTCGTCGGCACGGGGCTATT|CTCAAATCTGATCGTGGAATTACCAAGGGC
AGGGCTGAGAACAGCTCAAATTACCAAGGG|CTCAACCAAGGGCTGAGAACAGCTCATGAC
TTTGTTCAGTGCATAACCTGAGTGGAATTA|CTCATTCTAGGCTTACTTATAAGAATGGTA
TCAGTTAAGATATCCTAACTATTTCATCCA|CCTGTTCGCGCCGAGGGCGGCAAAGTGTGT
CAAGGGCTGAGAACAGCTCAGGTGTGGGTG|CATCCAGAATGTTTTGATTCTGGCGTCGAA
AGGGCTGAGAACAGTGGAATTACCAAGGGC|TGACTAAGCTACTGCCTATTGGTACAGTCT
GTGGAATTACCAAGGGCGTGGAATTACCAA|GCCTATTGGTACAGTCTCTAGCTATGGAAA
TTGATTCTGGCGTCGAAGTCCTAGACGCTA|CGAACTAATTAAATATTTTATCATGCGCAC
AACAGCTCAGCTGAGAACAGCTCATGAGAA|TCGGCATATTCGGTGGAAGGCAAACTTTGT
AATTACCAAGGGCTGAGAACAGCTCAGGTG|CTATTTCATCCAGAATGTTTTGATTCTGGC
GAACAGCTCAGCTGAGAACAGCTCATGAGA|GTCGGCATATTCGGTGGAAGGCAAACTTTG
TCCAGAATGTTTTGATTCTGGCGTCGAAGT|GTGTACGGCCACGAACTAATTAAATATTTT
GGAATTACCAAGGGCTGAGAACAGCTCAAA|TTAATTCGCGGCCCGCTATGGGTGGAATTA
TACCAAGGGCTGAGAACAGCTCAAATTACC|TAGACGCTATAGGGATCAGGTTTCAGAAAG
TCTGTATCATCTGCTGGGGTGTTGATCATT|TCATGGGATTTCGTCGGCACGGGGCTATTG
CATTCATGCTGAGGAGGGGGGGTTCAGTTA|TTAACACGATAGCGGCTACCGAACCTGTTC
AGAACAGTGGAATTACCAAGGGCGTGGAAT|GCTACTGCCTATTGGTACAGTCTCTAGCTA
CTGTACCCGTTCTTTGCAATATAAACCTTG|GGCTGAGAACAGCTCATCATACCGATCCAT
CTTACTTATGGGATGAGGTGGGAAGTGTCT|GGAATTACCAAGGGCTGAGAACAGCTCAGC
CATGGGATTTCGTCGGCACGGGGCTATTGC|CAAATCTGATCGTGGAATTACCAAGGGCTG
GTCGTCGGCATATTCGGTGGAAGGCAAACT|GTGAACGGGTAGTACCACCACGGAAATATC
ATGACTAAGCTACTGCCTATTGGTACAGTC|GTTCAGAACCAGTAGCTGTACCCGTTCTTT
GCTCATTCTAGGCTTACTTATAAGAATGGT|AATTACCAAGGGCTGAGAACAGCTCAAATT
GTGGAATTACCAAGGGCTGAGAACAGCTCA|CCGCAGGTGTCCACGGAAACCAGTGAAGCT
GTGGAATTACCAAGGGCTGAGAACAGCTCA|CTAACTATTTCATCCAGAATGTTTTGATTC
GGAAATCTCACTACTCTCCGAGTTGTCGTC|ACCTTGCCAAAAGCTTATGCGGTAGTGAAC
AGGGCGTGGAATTACCAAGGGTGGAATTAC|AGTCTCTAGCTATGGAAATCTCACTACTCT
GCTATGGAAATCTCACTACTCTCCGAGTTG|TATAAACCTTGCCAAAAGCTTATGCGGTAG
ATTTTTATCCAAGATTCCCAGATACTACAA|CAAGGGCTGAGAACAGCTCAGTACCTTGAG
ATTCGGTGGAAGGCAAACTTTGTCTTGTCC|GTACCACCACGGAAATATCCTATTGACACA
CCAAGGGCTGAGAACAGCTCAGAGACCTAA|TCCACGGAAACCAGTGAAGCTTCGATAACA
GGGCTGAGAACAGCTCAGCTGAGAACAGCT|AGTTGTCGTCGGCATATTCGGTGGAAGGCA
AAGGGCTGAGAACAGTGGAATTACCAAGGG|ATGACTAAGCTACTGCCTATTGGTACAGTC
ACAGCTCAGCTCAACCAAGGGCTGAGAACA|TCTTGTCCTAGGACTACGACGTAAGCGATA
TGAGAACAGCTCAGTACCTTGAGCCGCAGG|GAATTACCAAGGGCTGAGAACAGCTCAAAG
CGACGTAAGCGATACACAGTTCAGAACCAG|AGTCTTGCCTCGATGGGCTGTGGAATTACC
CGGCCCGCTATGGGTGGAATTACCAAGGGC|CAGTTAAGATATCCTAACTATTTCATCCAG
CTACAAGTGGAATTACCAAGGGCTGAGAAC|CTTGAGCCGCAGGTGTCCACGGAAACCAGT
ACCAAGGGCTGAGAACAGCTCAAAGCACGT|ATTCAAATGCGGCCTTAACCGCAACTTTGT
AGCTCATTCTAGGCTTACTTATAAGAATGG|GAATTACCAAGGGCTGAGAACAGCTCAAAT
ACCAAGGGCTGAGAACAGCTCAGAGACCTA|GTCCACGGAAACCAGTGAAGCTTCGATAAC
CCAAGGGCTGAGAACAGCTCATGACTAAGC|TACGACGTAAGCGATACACAGTTCAGAACC
CTGAGAACAGCTCATGAGAACAGCTCAGCT|CGGTGGAAGGCAAACTTTGTCTTGTCCTAG
GTCGACAATTTTTATCCAAGATTCCCAGAT|GAATTACCAAGGGCTGAGAACAGCTCAGTA
GGGCGTGGAATTACCAAGGGTGGAATTACC|GTCTCTAGCTATGGAAATCTCACTACTCTC
TTTTTATCCAAGATTCCCAGATACTACAAG|AAGGGCTGAGAACAGCTCAGTACCTTGAGC
CAGAACCAGTAGCTGTACCCGTTCTTTGCA|GGAATTACCAAGGGCTGAGAACAGCTCATC
TGAGAACAGCTCAAATCTGATCGTGGAATT|CTATGGGTGGAATTACCAAGGGCTGAGAAC
TAACACTAGAGTCATGGGATTTCGTCGGCA|CTGAGAACAGCTCAAATCTGATCGTGGAAT
GTGGAAGGCAAACTTTGTCTTGTCCTAGGA|ACCACGGAAATATCCTATTGACACAATGTG
TACTTATAAGAATGGTATTCAAATGCGGCC|GAGAACAGCTCAAATTACCAAGGGCTGAGA
CATAACCTGAGTGGAATTACCAAGGGCTGA|CTTACTTATAAGAATGGTATTCAAATGCGG
TGTTCAGTGCATAACCTGAGTGGAATTACC|CATTCTAGGCTTACTTATAAGAATGGTATT
ATTCAATCGCGAGAGGGAGTGGAATTACCA|TTGCGTGTAAATTTGTTCAGTGCATAACCT
TCTCTTACTTATGGGATGAGGTGGGAAGTG|GGTGGAATTACCAAGGGCTGAGAACAGCTC
ACACAGTTCAGAACCAGTAGCTGTACCCGT|TGGGCTGTGGAATTACCAAGGGCTGAGAAC
ACACTAGAGTCATGGGATTTCGTCGGCACG|GAGAACAGCTCAAATCTGATCGTGGAATTA
GGAAATATCCTATTGACACAATGTGTTGAG|TCCTAGAAAAGTCGACAATTTTTATCCAAG
TTTATCCAAGATTCCCAGATACTACAAGTG|GGGCTGAGAACAGCTCAGTACCTTGAGCCG
GCCAAAAGCTTATGCGGTAGTGAACGGGTA|TGAGGACGTAGAGATACACTGAGCGCGGGT
GGGGTGTTGATCATTCAATCGCGAGAGGGA|GGCACGGGGCTATTGCGTGTAAATTTGTTC
TTGAGCCGCAGGTGTCCACGGAAACCAGTG|AACAGCTCAAAGCACGTTGTTAAGTGGAAT
CTATAGGGATCAGGTTTCAGAAAGACCCCT|CACAGGTCAGTCCTTTGAGCTACGGTTAAG
TGTCATAATAATTAATTCGCGGCCCGCTAT|ATGCTGAGGAGGGGGGGTTCAGTTAAGATA
GGTGGAATTACCAAGGGCTGAGAACAGCTC|CTCACTACTCTCCGAGTTGTCGTCGGCATA
CTTGAGCCGCAGGTGTCCACGGAAACCAGT|GAACAGCTCAAAGCACGTTGTTAAGTGGAA
CCACGCGAGAAGGTTAACACGATAGCGGCT|GGAGTACTGGTTGGCCTTCAGGGGCTCGAT
AGCAGCGCTTCTCTTACTTATGGGATGAGG|ATTACCAAGGGTGGAATTACCAAGGGCTGA
GGGATGAGGTGGGAAGTGTCTGAAGTGGAA|AAGGGCTGAGAACAGCTCAGCTGAGAACAG
TTATGCGGTAGTGAACGGGTAGTACCACCA|AGAGATACACTGAGCGCGGGTCTCGTGAGA
CAGCTCATCATACCGATCCATGAGGACGTA|CAGCTCAGAGACCTAACCCACCTCTGTATC
GCTATAGGGATCAGGTTTCAGAAAGACCCC|GCACAGGTCAGTCCTTTGAGCTACGGTTAA
GCACGTTGTTAAGTGGAATTACCAAGGGCT|CTTTGTCATAATAATTAATTCGCGGCCCGC
CCTTGCCAAAAGCTTATGCGGTAGTGAACG|TCCATGAGGACGTAGAGATACACTGAGCGC
ACAGCTCAAAGCACGTTGTTAAGTGGAATT|TTAACCGCAACTTTGTCATAATAATTAATT
TGGAATTACCAAGGGTGGAATTACCAAGGG|TAGCTATGGAAATCTCACTACTCTCCGAGT
CATGAGAACAGCTCAGCTCAACCAAGGGCT|AACTTTGTCTTGTCCTAGGACTACGACGTA
ACAGCTCACATTCATGCTGAGGAGGGGGGG|CGAGAAGGTTAACACGATAGCGGCTACCGA
CAGCTCACATTCATGCTGAGGAGGGGGGGT|GAGAAGGTTAACACGATAGCGGCTACCGAA
TATCCTATTGACACAATGTGTTGAGTCTTG|GAAAAGTCGACAATTTTTATCCAAGATTCC
GGGGTTCAGTTAAGATATCCTAACTATTTC|CCGAACCTGTTCGCGCCGAGGGCGGCAAAG
TTGTTAAGTGGAATTACCAAGGGCTGAGAA|TCATAATAATTAATTCGCGGCCCGCTATGG
CGGGGCTATTGCGTGTAAATTTGTTCAGTG|TACCAAGGGCTGAGAACAGCTCATTCTAGG
GAAGTCCTAGACGCTATAGGGATCAGGTTT|ATTTTATCATGCGCACAGGTCAGTCCTTTG
ATCCATGAGGACGTAGAGATACACTGAGCG|ACCCACCTCTGTATCATCTGCTGGGGTGTT
GCAGCGCTTCTCTTACTTATGGGATGAGGT|TTACCAAGGGTGGAATTACCAAGGGCTGAG
GAGGGAGTGGAATTACCAAGGGCTGAGAAC|TTGTTCAGTGCATAACCTGAGTGGAATTAC
ATACACTGAGCGCGGGTCTCGTGAGACTCC|TGCTGGGGTGTTGATCATTCAATCGCGAGA
TTGTCGTCGGCATATTCGGTGGAAGGCAAA|TAGTGAACGGGTAGTACCACCACGGAAATA
GCTCAGTACCTTGAGCCGCAGGTGTCCACG|AAGGGCTGAGAACAGCTCAAAGCACGTTGT
GGAATTACCAAGGGCTGAGAACAGCTCAGC|ACTACTCTCCGAGTTGTCGTCGGCATATTC
CAGCTGAGAACAGCTCATGAGAACAGCTCA|ATTCGGTGGAAGGCAAACTTTGTCTTGTCC
ACGGGGCTATTGCGTGTAAATTTGTTCAGT|TTACCAAGGGCTGAGAACAGCTCATTCTAG
ACCAAGGGCTGAGAACAGCTCAGCTGAGAA|CTCCGAGTTGTCGTCGGCATATTCGGTGGA
AGCTGAGAACAGCTCATGAGAACAGCTCAG|TTCGGTGGAAGGCAAACTTTGTCTTGTCCT
CATATTCGGTGGAAGGCAAACTTTGTCTTG|GTAGTACCACCACGGAAATATCCTATTGAC
GAATTACCAAGGGCTGAGAACAGCTCAGTA|GCATAACCTGAGTGGAATTACCAAGGGCTG
AATAATTAATTCGCGGCCCGCTATGGGTGG|AGGAGGGGGGGTTCAGTTAAGATATCCTAA
AAGTCCTAGACGCTATAGGGATCAGGTTTC|TTTTATCATGCGCACAGGTCAGTCCTTTGA
TCATCTGCTGGGGTGTTGATCATTCAATCG|GATTTCGTCGGCACGGGGCTATTGCGTGTA
AGCTTATGCGGTAGTGAACGGGTAGTACCA|CGTAGAGATACACTGAGCGCGGGTCTCGTG
GAGAACAGCTCATTCTAGGCTTACTTATAA|TGGGTGGAATTACCAAGGGCTGAGAACAGC
ATCTCACTACTCTCCGAGTTGTCGTCGGCA|TGCCAAAAGCTTATGCGGTAGTGAACGGGT
GAATTACCAAGGGCTGAGAACAGCTCAGGT|ACTATTTCATCCAGAATGTTTTGATTCTGG
GAAAAGTCGACAATTTTTATCCAAGATTCC|GAGTGGAATTACCAAGGGCTGAGAACAGCT
CGGCATATTCGGTGGAAGGCAAACTTTGTC|CGGGTAGTACCACCACGGAAATATCCTATT
TATAAACCTTGCCAAAAGCTTATGCGGTAG|TACCGATCCATGAGGACGTAGAGATACACT
GGCCCGCTATGGGTGGAATTACCAAGGGCT|AGTTAAGATATCCTAACTATTTCATCCAGA
GATTCTGGCGTCGAAGTCCTAGACGCTATA|AACTAATTAAATATTTTATCATGCGCACAG
TCATGAGAACAGCTCAGCTCAACCAAGGGC|AAACTTTGTCTTGTCCTAGGACTACGACGT
CACATTCATGCTGAGGAGGGGGGGTTCAGT|GGTTAACACGATAGCGGCTACCGAACCTGT
AATATAAACCTTGCCAAAAGCTTATGCGGT|CATACCGATCCATGAGGACGTAGAGATACA
AGCTCAAATTACCAAGGGCTGAGAACAGTG|CTGAGAACAGCTCATGACTAAGCTACTGCC
AATTACCAAGGGCGTGGAATTACCAAGGGT|ATTGGTACAGTCTCTAGCTATGGAAATCTC
TATTTCATCCAGAATGTTTTGATTCTGGCG|GCAAAGTGTGTACGGCCACGAACTAATTAA
ACATTCATGCTGAGGAGGGGGGGTTCAGTT|GTTAACACGATAGCGGCTACCGAACCTGTT
TCAGCTCAACCAAGGGCTGAGAACAGCTCA|TCCTAGGACTACGACGTAAGCGATACACAG
AGCACGTTGTTAAGTGGAATTACCAAGGGC|ACTTTGTCATAATAATTAATTCGCGGCCCG
GGCTGAGAACAGCTCAAATTACCAAGGGCT|CAACCAAGGGCTGAGAACAGCTCATGACTA
AGTCTTGCCTCGATGGGCTGTGGAATTACC|AGATTCCCAGATACTACAAGTGGAATTACC
TGAGAACAGTGGAATTACCAAGGGCGTGGA|AAGCTACTGCCTATTGGTACAGTCTCTAGC
TGCCTATTGGTACAGTCTCTAGCTATGGAA|AGCTGTACCCGTTCTTTGCAATATAAACCT
GAACAGCTCATTCTAGGCTTACTTATAAGA|GGTGGAATTACCAAGGGCTGAGAACAGCTC
GCTCAGGTGTGGGTGGAATTACCAAGGGCT|GATTCTGGCGTCGAAGTCCTAGACGCTATA
CTCCGAGTTGTCGTCGGCATATTCGGTGGA|TATGCGGTAGTGAACGGGTAGTACCACCAC
GGCACGGGGCTATTGCGTGTAAATTTGTTC|GAATTACCAAGGGCTGAGAACAGCTCATTC
GCTGTACCCGTTCTTTGCAATATAAACCTT|GGGCTGAGAACAGCTCATCATACCGATCCA
AGGACTACGACGTAAGCGATACACAGTTCA|TGTGTTGAGTCTTGCCTCGATGGGCTGTGG
CACTGAGCGCGGGTCTCGTGAGACTCCTAG|TGGGGTGTTGATCATTCAATCGCGAGAGGG
AAGTGGAATTACCAAGGGCTGAGAACAGCT|AGCCGCAGGTGTCCACGGAAACCAGTGAAG
AGACTCCTAGAAAAGTCGACAATTTTTATC|CGCGAGAGGGAGTGGAATTACCAAGGGCTG
CAGTAGCTGTACCCGTTCTTTGCAATATAA|ACCAAGGGCTGAGAACAGCTCATCATACCG
TCGATAACACTAGAGTCATGGGATTTCGTC|AGGGCTGAGAACAGCTCAAATCTGATCGTG
ACACAATGTGTTGAGTCTTGCCTCGATGGG|CAATTTTTATCCAAGATTCCCAGATACTAC
TACTACAAGTGGAATTACCAAGGGCTGAGA|ACCTTGAGCCGCAGGTGTCCACGGAAACCA
TACTGCCTATTGGTACAGTCTCTAGCTATG|AGTAGCTGTACCCGTTCTTTGCAATATAAA
GTAAATTTGTTCAGTGCATAACCTGAGTGG|AACAGCTCATTCTAGGCTTACTTATAAGAA
ATGCTGAGGAGGGGGGGTTCAGTTAAGATA|ACGATAGCGGCTACCGAACCTGTTCGCGCC
AAGTGTCTGAAGTGGAATTGTGGGTGGAAT|AGCTCAGCTGAGAACAGCTCATGAGAACAG
ATCCTAACTATTTCATCCAGAATGTTTTGA|CGAGGGCGGCAAAGTGTGTACGGCCACGAA
GAATTACCAAGGGCTGAGAACAGCTCATCA|GAATTACCAAGGGCTGAGAACAGCTCAGAG
GAGTCTTGCCTCGATGGGCTGTGGAATTAC|AAGATTCCCAGATACTACAAGTGGAATTAC
AGGGAGTGGAATTACCAAGGGCTGAGAACA|TGTTCAGTGCATAACCTGAGTGGAATTACC
AAATCTCACTACTCTCCGAGTTGTCGTCGG|CTTGCCAAAAGCTTATGCGGTAGTGAACGG
GAGACTCCTAGAAAAGTCGACAATTTTTAT|TCGCGAGAGGGAGTGGAATTACCAAGGGCT
ATCTGCTGGGGTGTTGATCATTCAATCGCG|TTTCGTCGGCACGGGGCTATTGCGTGTAAA
TGTGGGTGGAATTACCAAGGGCTGAGAACA|GCGTCGAAGTCCTAGACGCTATAGGGATCA
CGCTATGGGTGGAATTACCAAGGGCTGAGA|AAGATATCCTAACTATTTCATCCAGAATGT
CGAGAAGGTTAACACGATAGCGGCTACCGA|ACTGGTTGGCCTTCAGGGGCTCGATGGAAA
ATTCTGGCGTCGAAGTCCTAGACGCTATAG|ACTAATTAAATATTTTATCATGCGCACAGG
CAGCTCAGAGACCTAACCCACCTCTGTATC|TGAAGCTTCGATAACACTAGAGTCATGGGA
ATTAATTCGCGGCCCGCTATGGGTGGAATT|GGGGGGGTTCAGTTAAGATATCCTAACTAT
AATGGTATTCAAATGCGGCCTTAACCGCAA|CAAATTACCAAGGGCTGAGAACAGCTCACA
GAGAACAGCTCAAAGCACGTTGTTAAGTGG|GGCCTTAACCGCAACTTTGTCATAATAATT
TCAGGTGTGGGTGGAATTACCAAGGGCTGA|TTCTGGCGTCGAAGTCCTAGACGCTATAGG
CTTTGTCTTGTCCTAGGACTACGACGTAAG|TCCTATTGACACAATGTGTTGAGTCTTGCC
CTCTCCGAGTTGTCGTCGGCATATTCGGTG|CTTATGCGGTAGTGAACGGGTAGTACCACC
GGGCTGAGAACAGCTCATCATACCGATCCA|GGGCTGAGAACAGCTCAGAGACCTAACCCA
CAAGGGCTGAGAACAGCTCATCATACCGAT|CAAGGGCTGAGAACAGCTCAGAGACCTAAC
GCTCAAATCTGATCGTGGAATTACCAAGGG|GGAATTACCAAGGGCTGAGAACAGCTCAGG
AGGGGGGGTTCAGTTAAGATATCCTAACTA|GCTACCGAACCTGTTCGCGCCGAGGGCGGC
ATCATCTGCTGGGGTGTTGATCATTCAATC|GGATTTCGTCGGCACGGGGCTATTGCGTGT
AACCGCAACTTTGTCATAATAATTAATTCG|AGCTCACATTCATGCTGAGGAGGGGGGGTT
ACCCGTTCTTTGCAATATAAACCTTGCCAA|GAGAACAGCTCATCATACCGATCCATGAGG
TCAAATCTGATCGTGGAATTACCAAGGGCT|AATTACCAAGGGCTGAGAACAGCTCAGGTG
ACCGCAACTTTGTCATAATAATTAATTCGC|GCTCACATTCATGCTGAGGAGGGGGGGTTC
AGGGCTGAGAACAGCTCAGGTGTGGGTGGA|TCCAGAATGTTTTGATTCTGGCGTCGAAGT
AGAGACCTAACCCACCTCTGTATCATCTGC|TTCGATAACACTAGAGTCATGGGATTTCGT
CAGTGGAATTACCAAGGGCGTGGAATTACC|CTGCCTATTGGTACAGTCTCTAGCTATGGA
GCCTATTGGTACAGTCTCTAGCTATGGAAA|GCTGTACCCGTTCTTTGCAATATAAACCTT
GCTGAGAACAGCTCAGCTGAGAACAGCTCA|TTGTCGTCGGCATATTCGGTGGAAGGCAAA
TTCGGTGGAAGGCAAACTTTGTCTTGTCCT|TACCACCACGGAAATATCCTATTGACACAA
GGTGTCCACGGAAACCAGTGAAGCTTCGAT|AGCACGTTGTTAAGTGGAATTACCAAGGGC
TTCGTCGGCACGGGGCTATTGCGTGTAAAT|ATCGTGGAATTACCAAGGGCTGAGAACAGC
TCGTCGGCACGGGGCTATTGCGTGTAAATT|TCGTGGAATTACCAAGGGCTGAGAACAGCT
ACTTTGTCATAATAATTAATTCGCGGCCCG|ATTCATGCTGAGGAGGGGGGGTTCAGTTAA
GACTACGACGTAAGCGATACACAGTTCAGA|TGTTGAGTCTTGCCTCGATGGGCTGTGGAA
AACAGCTCAAATTACCAAGGGCTGAGAACA|ATCAGGTTTCAGAAAGACCCCTCCACGCGA
TCACATTCATGCTGAGGAGGGGGGGTTCAG|AGGTTAACACGATAGCGGCTACCGAACCTG
AGTGGAATTACCAAGGGCTGAGAACAGCTC|GCCGCAGGTGTCCACGGAAACCAGTGAAGC
TATGGGTGGAATTACCAAGGGCTGAGAACA|ATATCCTAACTATTTCATCCAGAATGTTTT
CACTAGAGTCATGGGATTTCGTCGGCACGG|AGAACAGCTCAAATCTGATCGTGGAATTAC
AACAGCTCAGGTGTGGGTGGAATTACCAAG|TTTTGATTCTGGCGTCGAAGTCCTAGACGC
TTGCCTCGATGGGCTGTGGAATTACCAAGG|TCCCAGATACTACAAGTGGAATTACCAAGG
AGCTCAACCAAGGGCTGAGAACAGCTCATG|CTAGGACTACGACGTAAGCGATACACAGTT
TCCTAACTATTTCATCCAGAATGTTTTGAT|GAGGGCGGCAAAGTGTGTACGGCCACGAAC
TCTGATCGTGGAATTACCAAGGGCTGAGAA|CCAAGGGCTGAGAACAGCTCAGGTGTGGGT
ATAATTAATTCGCGGCCCGCTATGGGTGGA|GGAGGGGGGGTTCAGTTAAGATATCCTAAC
TACCGATCCATGAGGACGTAGAGATACACT|ACCTAACCCACCTCTGTATCATCTGCTGGG
ACCAAGGGCTGAGAACAGCTCAAATTACCA|TCAGCTCAACCAAGGGCTGAGAACAGCTCA
GGAATTACCAAGGGCTGAGAACAGCTCAGG|AACTATTTCATCCAGAATGTTTTGATTCTG
TTCAGAACCAGTAGCTGTACCCGTTCTTTG|GTGGAATTACCAAGGGCTGAGAACAGCTCA
CCTCTGTATCATCTGCTGGGGTGTTGATCA|AGTCATGGGATTTCGTCGGCACGGGGCTAT
TAACACGATAGCGGCTACCGAACCTGTTCG|CCTTCAGGGGCTCGATGGAAACTCGAAAAG
GTCGAAGTCCTAGACGCTATAGGGATCAGG|AATATTTTATCATGCGCACAGGTCAGTCCT
AGAAGGTTAACACGATAGCGGCTACCGAAC|TGGTTGGCCTTCAGGGGCTCGATGGAAACT
TTACCAAGGGCTGAGAACAGCTCAGCTGAG|CTCTCCGAGTTGTCGTCGGCATATTCGGTG
AGAACAGCTCAAATTACCAAGGGCTGAGAA|AAGGGCTGAGAACAGCTCATGACTAAGCTA
TTACCAAGGGCTGAGAACAGCTCAAAGCAC|GTATTCAAATGCGGCCTTAACCGCAACTTT
CAGGTGTGGGTGGAATTACCAAGGGCTGAG|TCTGGCGTCGAAGTCCTAGACGCTATAGGG
AACAGCTCATTCTAGGCTTACTTATAAGAA|GTGGAATTACCAAGGGCTGAGAACAGCTCA
AGCTCATGACTAAGCTACTGCCTATTGGTA|ACACAGTTCAGAACCAGTAGCTGTACCCGT
TTGTCCTAGGACTACGACGTAAGCGATACA|GACACAATGTGTTGAGTCTTGCCTCGATGG
GAGAACAGCTCAGTACCTTGAGCCGCAGGT|AATTACCAAGGGCTGAGAACAGCTCAAAGC
GGTGGAATTACCAAGGGCTGAGAACAGCTC|CCTAACTATTTCATCCAGAATGTTTTGATT
ACCAGTGAAGCTTCGATAACACTAGAGTCA|GTGGAATTACCAAGGGCTGAGAACAGCTCA
GCTGAGAACAGCTCACATTCATGCTGAGGA|CTCCACGCGAGAAGGTTAACACGATAGCGG
AATGCGGCCTTAACCGCAACTTTGTCATAA|GGGCTGAGAACAGCTCACATTCATGCTGAG
CAGATACTACAAGTGGAATTACCAAGGGCT|CAGTACCTTGAGCCGCAGGTGTCCACGGAA
GACCTAACCCACCTCTGTATCATCTGCTGG|GATAACACTAGAGTCATGGGATTTCGTCGG
GAATTACCAAGGGCGTGGAATTACCAAGGG|TATTGGTACAGTCTCTAGCTATGGAAATCT
CTGATCGTGGAATTACCAAGGGCTGAGAAC|CAAGGGCTGAGAACAGCTCAGGTGTGGGTG
AGATACACTGAGCGCGGGTCTCGTGAGACT|TCTGCTGGGGTGTTGATCATTCAATCGCGA
CTGAGAACAGCTCATTCTAGGCTTACTTAT|TGTGGGTGGAATTACCAAGGGCTGAGAACA
CCAGATACTACAAGTGGAATTACCAAGGGC|TCAGTACCTTGAGCCGCAGGTGTCCACGGA
GTGTCCACGGAAACCAGTGAAGCTTCGATA|GCACGTTGTTAAGTGGAATTACCAAGGGCT
ACCAAGGGCTGAGAACAGCTCATTCTAGGC|AGCTCAGGTGTGGGTGGAATTACCAAGGGC
GCGGTAGTGAACGGGTAGTACCACCACGGA|ATACACTGAGCGCGGGTCTCGTGAGACTCC
TCAGCTGAGAACAGCTCATGAGAACAGCTC|TATTCGGTGGAAGGCAAACTTTGTCTTGTC
GGAATTACCAAGGGCTGAGAACAGCTCAAA|AATGGTATTCAAATGCGGCCTTAACCGCAA
GCAGGTGTCCACGGAAACCAGTGAAGCTTC|CAAAGCACGTTGTTAAGTGGAATTACCAAG
AAATATCCTATTGACACAATGTGTTGAGTC|CTAGAAAAGTCGACAATTTTTATCCAAGAT
GTCATAATAATTAATTCGCGGCCCGCTATG|TGCTGAGGAGGGGGGGTTCAGTTAAGATAT
GCAAACTTTGTCTTGTCCTAGGACTACGAC|AAATATCCTATTGACACAATGTGTTGAGTC
GAAGTGTCTGAAGTGGAATTGTGGGTGGAA|CAGCTCAGCTGAGAACAGCTCATGAGAACA
TCGCGAGAGGGAGTGGAATTACCAAGGGCT|GTAAATTTGTTCAGTGCATAACCTGAGTGG
ATAGCGGCTACCGAACCTGTTCGCGCCGAG|GGGCTCGATGGAAACTCGAAAAGATGCGTA
GAATTACCAAGGGTGGAATTACCAAGGGCT|GCTATGGAAATCTCACTACTCTCCGAGTTG
CTCTAGCTATGGAAATCTCACTACTCTCCG|TGCAATATAAACCTTGCCAAAAGCTTATGC
CTCATCATACCGATCCATGAGGACGTAGAG|CTCAGAGACCTAACCCACCTCTGTATCATC
TGGAAGGCAAACTTTGTCTTGTCCTAGGAC|CCACGGAAATATCCTATTGACACAATGTGT
TTCTAGGCTTACTTATAAGAATGGTATTCA|CCAAGGGCTGAGAACAGCTCAAATTACCAA
AGTACCTTGAGCCGCAGGTGTCCACGGAAA|GCTGAGAACAGCTCAAAGCACGTTGTTAAG
ATTACCAAGGGCTGAGAACAGTGGAATTAC|CAGCTCATGACTAAGCTACTGCCTATTGGT
CGGAAATATCCTATTGACACAATGTGTTGA|CTCCTAGAAAAGTCGACAATTTTTATCCAA
TGCTGGGGTGTTGATCATTCAATCGCGAGA|CGTCGGCACGGGGCTATTGCGTGTAAATTT
CAGTACCTTGAGCCGCAGGTGTCCACGGAA|GGCTGAGAACAGCTCAAAGCACGTTGTTAA
CCAAGGGCTGAGAACAGCTCACATTCATGC|AGACCCCTCCACGCGAGAAGGTTAACACGA
CCAAGATTCCCAGATACTACAAGTGGAATT|GAGAACAGCTCAGTACCTTGAGCCGCAGGT
GTGGGTGGAATTACCAAGGGCTGAGAACAG|CGTCGAAGTCCTAGACGCTATAGGGATCAG
ACAGTGGAATTACCAAGGGCGTGGAATTAC|ACTGCCTATTGGTACAGTCTCTAGCTATGG
TCAGAAAGACCCCTCCACGCGAGAAGGTTA|GAGCTACGGTTAAGGGAGTACTGGTTGGCC
TCAAATGCGGCCTTAACCGCAACTTTGTCA|CAAGGGCTGAGAACAGCTCACATTCATGCT
TGCTGAGGAGGGGGGGTTCAGTTAAGATAT|CGATAGCGGCTACCGAACCTGTTCGCGCCG
GGCAAAGCAGCGCTTCTCTTACTTATGGGA|GTGGAATTACCAAGGGTGGAATTACCAAGG
ATTACCAAGGGCGTGGAATTACCAAGGGTG|TTGGTACAGTCTCTAGCTATGGAAATCTCA
GAGAACAGCTCAGCTCAACCAAGGGCTGAG|TTTGTCTTGTCCTAGGACTACGACGTAAGC
GGCTGAGAACAGCTCATGACTAAGCTACTG|CGTAAGCGATACACAGTTCAGAACCAGTAG
AGGACGTAGAGATACACTGAGCGCGGGTCT|TCTGTATCATCTGCTGGGGTGTTGATCATT
GCTTCTCTTACTTATGGGATGAGGTGGGAA|AAGGGTGGAATTACCAAGGGCTGAGAACAG
ACAGCTCAAATTACCAAGGGCTGAGAACAG|TCAGGTTTCAGAAAGACCCCTCCACGCGAG
ACAGCTCAGGTGTGGGTGGAATTACCAAGG|TTTGATTCTGGCGTCGAAGTCCTAGACGCT
CGATAACACTAGAGTCATGGGATTTCGTCG|GGGCTGAGAACAGCTCAAATCTGATCGTGG
TTATAAGAATGGTATTCAAATGCGGCCTTA|AACAGCTCAAATTACCAAGGGCTGAGAACA
CGCGGGTCTCGTGAGACTCCTAGAAAAGTC|TTGATCATTCAATCGCGAGAGGGAGTGGAA
AACCAGTGAAGCTTCGATAACACTAGAGTC|AGTGGAATTACCAAGGGCTGAGAACAGCTC
AGATTCCCAGATACTACAAGTGGAATTACC|AACAGCTCAGTACCTTGAGCCGCAGGTGTC
GTCTGAAGTGGAATTGTGGGTGGAATTACC|CAGCTGAGAACAGCTCATGAGAACAGCTCA
CTGAAGTGGAATTGTGGGTGGAATTACCAA|GCTGAGAACAGCTCATGAGAACAGCTCAGC
TTCGCGGCCCGCTATGGGTGGAATTACCAA|GGTTCAGTTAAGATATCCTAACTATTTCAT
CTATTGCGTGTAAATTTGTTCAGTGCATAA|AGGGCTGAGAACAGCTCATTCTAGGCTTAC
GAGTCATGGGATTTCGTCGGCACGGGGCTA|AGCTCAAATCTGATCGTGGAATTACCAAGG
GGTGTGGGTGGAATTACCAAGGGCTGAGAA|TGGCGTCGAAGTCCTAGACGCTATAGGGAT
GAACGGGTAGTACCACCACGGAAATATCCT|AGCGCGGGTCTCGTGAGACTCCTAGAAAAG
ATTACCAAGGGCTGAGAACAGCTCAGCTGA|ACTCTCCGAGTTGTCGTCGGCATATTCGGT
CAATGTGTTGAGTCTTGCCTCGATGGGCTG|TTTTTATCCAAGATTCCCAGATACTACAAG
CGATAGCGGCTACCGAACCTGTTCGCGCCG|AGGGGCTCGATGGAAACTCGAAAAGATGCG
GGGTGTTGATCATTCAATCGCGAGAGGGAG|GCACGGGGCTATTGCGTGTAAATTTGTTCA
ATATTCGGTGGAAGGCAAACTTTGTCTTGT|TAGTACCACCACGGAAATATCCTATTGACA
AGTAGCTGTACCCGTTCTTTGCAATATAAA|CCAAGGGCTGAGAACAGCTCATCATACCGA
AAGGGCTGAGAACAGCTCAAAGCACGTTGT|CAAATGCGGCCTTAACCGCAACTTTGTCAT
GGGCTGAGAACAGTGGAATTACCAAGGGCG|GACTAAGCTACTGCCTATTGGTACAGTCTC
TCTTTGCAATATAAACCTTGCCAAAAGCTT|AGCTCATCATACCGATCCATGAGGACGTAG
TACCTTGAGCCGCAGGTGTCCACGGAAACC|TGAGAACAGCTCAAAGCACGTTGTTAAGTG
CCTGAGTGGAATTACCAAGGGCTGAGAACA|TTATAAGAATGGTATTCAAATGCGGCCTTA
GTACAGTCTCTAGCTATGGAAATCTCACTA|CGTTCTTTGCAATATAAACCTTGCCAAAAG
ACGACGTAAGCGATACACAGTTCAGAACCA|GAGTCTTGCCTCGATGGGCTGTGGAATTAC
CTCACATTCATGCTGAGGAGGGGGGGTTCA|AAGGTTAACACGATAGCGGCTACCGAACCT
TATGCGGTAGTGAACGGGTAGTACCACCAC|GAGATACACTGAGCGCGGGTCTCGTGAGAC
TGAGAACAGCTCATGAGAACAGCTCAGCTC|GGTGGAAGGCAAACTTTGTCTTGTCCTAGG
GAGAACAGCTCAGAGACCTAACCCACCTCT|ACCAGTGAAGCTTCGATAACACTAGAGTCA
CATGCTGAGGAGGGGGGGTTCAGTTAAGAT|CACGATAGCGGCTACCGAACCTGTTCGCGC
TGTACCCGTTCTTTGCAATATAAACCTTGC|GCTGAGAACAGCTCATCATACCGATCCATG
CAAGGGTGGAATTACCAAGGGCTGAGAACA|AAATCTCACTACTCTCCGAGTTGTCGTCGG
TCTGGCGTCGAAGTCCTAGACGCTATAGGG|TAATTAAATATTTTATCATGCGCACAGGTC
TCTCCGAGTTGTCGTCGGCATATTCGGTGG|TTATGCGGTAGTGAACGGGTAGTACCACCA
TATTCGGTGGAAGGCAAACTTTGTCTTGTC|AGTACCACCACGGAAATATCCTATTGACAC
AACAGCTCAGAGACCTAACCCACCTCTGTA|AGTGAAGCTTCGATAACACTAGAGTCATGG
CTTGTCCTAGGACTACGACGTAAGCGATAC|TGACACAATGTGTTGAGTCTTGCCTCGATG
AGTACCACCACGGAAATATCCTATTGACAC|TCTCGTGAGACTCCTAGAAAAGTCGACAAT
TTGCCAAAAGCTTATGCGGTAGTGAACGGG|CATGAGGACGTAGAGATACACTGAGCGCGG
TTCAGAAAGACCCCTCCACGCGAGAAGGTT|TGAGCTACGGTTAAGGGAGTACTGGTTGGC
TGGGCTGTGGAATTACCAAGGGCTGAGAAC|CTACAAGTGGAATTACCAAGGGCTGAGAAC
ACAATGTGTTGAGTCTTGCCTCGATGGGCT|ATTTTTATCCAAGATTCCCAGATACTACAA
ATGAGAACAGCTCAGCTCAACCAAGGGCTG|ACTTTGTCTTGTCCTAGGACTACGACGTAA
CGGGTAGTACCACCACGGAAATATCCTATT|GCGGGTCTCGTGAGACTCCTAGAAAAGTCG
CCTCCACGCGAGAAGGTTAACACGATAGCG|AAGGGAGTACTGGTTGGCCTTCAGGGGCTC
TTTTGATTCTGGCGTCGAAGTCCTAGACGC|CACGAACTAATTAAATATTTTATCATGCGC
AAGGGCTGAGAACAGCTCAGCTGAGAACAG|CGAGTTGTCGTCGGCATATTCGGTGGAAGG
GGCAAACTTTGTCTTGTCCTAGGACTACGA|GAAATATCCTATTGACACAATGTGTTGAGT
GGAGGGGGGGTTCAGTTAAGATATCCTAAC|CGGCTACCGAACCTGTTCGCGCCGAGGGCG
CGAGTTGTCGTCGGCATATTCGGTGGAAGG|GCGGTAGTGAACGGGTAGTACCACCACGGA
CTGAGAACAGCTCAGCTGAGAACAGCTCAT|TGTCGTCGGCATATTCGGTGGAAGGCAAAC
CTGAGAACAGCTCAAATCTGATCGTGGAAT|GCTATGGGTGGAATTACCAAGGGCTGAGAA
CTATTGACACAATGTGTTGAGTCTTGCCTC|AGTCGACAATTTTTATCCAAGATTCCCAGA
AAGTCGACAATTTTTATCCAAGATTCCCAG|TGGAATTACCAAGGGCTGAGAACAGCTCAG
ACGTAAGCGATACACAGTTCAGAACCAGTA|TCTTGCCTCGATGGGCTGTGGAATTACCAA
TAGTGAACGGGTAGTACCACCACGGAAATA|ACTGAGCGCGGGTCTCGTGAGACTCCTAGA
ACGGAAATATCCTATTGACACAATGTGTTG|ACTCCTAGAAAAGTCGACAATTTTTATCCA
AAGATATCCTAACTATTTCATCCAGAATGT|CGCGCCGAGGGCGGCAAAGTGTGTACGGCC
AAGGGCTGAGAACAGCTCAGTACCTTGAGC|TGAGTGGAATTACCAAGGGCTGAGAACAGC
AAGGGCTGAGAACAGCTCAGAGACCTAACC|CACGGAAACCAGTGAAGCTTCGATAACACT
TGGAATTACCAAGGGCTGAGAACAGCTCAA|GAACAGCTCAGCTCAACCAAGGGCTGAGAA
AGCTCAGAGACCTAACCCACCTCTGTATCA|GAAGCTTCGATAACACTAGAGTCATGGGAT
GGGTGGAATTACCAAGGGCTGAGAACAGCT|TCGAAGTCCTAGACGCTATAGGGATCAGGT
GCGGGTCTCGTGAGACTCCTAGAAAAGTCG|TGATCATTCAATCGCGAGAGGGAGTGGAAT
AACACGATAGCGGCTACCGAACCTGTTCGC|CTTCAGGGGCTCGATGGAAACTCGAAAAGA
AATTACCAAGGGTGGAATTACCAAGGGCTG|CTATGGAAATCTCACTACTCTCCGAGTTGT
TTCATCCAGAATGTTTTGATTCTGGCGTCG|AAGTGTGTACGGCCACGAACTAATTAAATA
CTGCTGGGGTGTTGATCATTCAATCGCGAG|TCGTCGGCACGGGGCTATTGCGTGTAAATT
CCAAGGGCGTGGAATTACCAAGGGTGGAAT|TACAGTCTCTAGCTATGGAAATCTCACTAC
TGGAATTACCAAGGGCTGAGAACAGCTCAT|TGGAATTACCAAGGGCTGAGAACAGCTCAG
GCTGAGGAGGGGGGGTTCAGTTAAGATATC|GATAGCGGCTACCGAACCTGTTCGCGCCGA
CTTACTTATAAGAATGGTATTCAAATGCGG|CTGAGAACAGCTCAAATTACCAAGGGCTGA
AACGGGTAGTACCACCACGGAAATATCCTA|GCGCGGGTCTCGTGAGACTCCTAGAAAAGT
TATTGGTACAGTCTCTAGCTATGGAAATCT|GTACCCGTTCTTTGCAATATAAACCTTGCC
CCAAGGGCTGAGAACAGCTCAAATTACCAA|GACGCTATAGGGATCAGGTTTCAGAAAGAC
CGCTTCTCTTACTTATGGGATGAGGTGGGA|CAAGGGTGGAATTACCAAGGGCTGAGAACA
GCTCAGAGACCTAACCCACCTCTGTATCAT|AAGCTTCGATAACACTAGAGTCATGGGATT
CTCAAAGCACGTTGTTAAGTGGAATTACCA|CCGCAACTTTGTCATAATAATTAATTCGCG
GGTACAGTCTCTAGCTATGGAAATCTCACT|CCGTTCTTTGCAATATAAACCTTGCCAAAA
TAGAGTCATGGGATTTCGTCGGCACGGGGC|ACAGCTCAAATCTGATCGTGGAATTACCAA
TAAGATATCCTAACTATTTCATCCAGAATG|TCGCGCCGAGGGCGGCAAAGTGTGTACGGC
AAGGGCTGAGAACAGCTCAAATTACCAAGG|GCTCAACCAAGGGCTGAGAACAGCTCATGA
ATTACCAAGGGCTGAGAACAGCTCAAATTA|AGCTCAGCTCAACCAAGGGCTGAGAACAGC
TGCCTCGATGGGCTGTGGAATTACCAAGGG|CCCAGATACTACAAGTGGAATTACCAAGGG
AATTACCAAGGGCTGAGAACAGCTCAAATT|TCCTAGACGCTATAGGGATCAGGTTTCAGA
ATGCGGTAGTGAACGGGTAGTACCACCACG|AGATACACTGAGCGCGGGTCTCGTGAGACT
GCACGGGGCTATTGCGTGTAAATTTGTTCA|AATTACCAAGGGCTGAGAACAGCTCATTCT
TTGCGTGTAAATTTGTTCAGTGCATAACCT|GCTGAGAACAGCTCATTCTAGGCTTACTTA
ACAAGTGGAATTACCAAGGGCTGAGAACAG|TGAGCCGCAGGTGTCCACGGAAACCAGTGA
AACCAGTAGCTGTACCCGTTCTTTGCAATA|ATTACCAAGGGCTGAGAACAGCTCATCATA
AGGCTTACTTATAAGAATGGTATTCAAATG|GGGCTGAGAACAGCTCAAATTACCAAGGGC
AAGGGTGGAATTACCAAGGGCTGAGAACAG|AATCTCACTACTCTCCGAGTTGTCGTCGGC
GGCATATTCGGTGGAAGGCAAACTTTGTCT|GGGTAGTACCACCACGGAAATATCCTATTG
GGCTGAGAACAGCTCACATTCATGCTGAGG|CCTCCACGCGAGAAGGTTAACACGATAGCG
ACAGCTCATTCTAGGCTTACTTATAAGAAT|TGGAATTACCAAGGGCTGAGAACAGCTCAA
TGACTAAGCTACTGCCTATTGGTACAGTCT|TTCAGAACCAGTAGCTGTACCCGTTCTTTG
GGTTAACACGATAGCGGCTACCGAACCTGT|TGGCCTTCAGGGGCTCGATGGAAACTCGAA
TATGGGATGAGGTGGGAAGTGTCTGAAGTG|ACCAAGGGCTGAGAACAGCTCAGCTGAGAA
AGGGCTGAGAACAGCTCAAATTACCAAGGG|GCTATAGGGATCAGGTTTCAGAAAGACCCC
GCTTACTTATAAGAATGGTATTCAAATGCG|GCTGAGAACAGCTCAAATTACCAAGGGCTG
TCTCACTACTCTCCGAGTTGTCGTCGGCAT|GCCAAAAGCTTATGCGGTAGTGAACGGGTA
GCCGCAGGTGTCCACGGAAACCAGTGAAGC|GCTCAAAGCACGTTGTTAAGTGGAATTACC
TTGTGGGTGGAATTACCAAGGGCTGAGAAC|CTCATGAGAACAGCTCAGCTCAACCAAGGG
TGACACAATGTGTTGAGTCTTGCCTCGATG|GACAATTTTTATCCAAGATTCCCAGATACT
AGGAGGGGGGGTTCAGTTAAGATATCCTAA|GCGGCTACCGAACCTGTTCGCGCCGAGGGC
ATTGCGTGTAAATTTGTTCAGTGCATAACC|GGCTGAGAACAGCTCATTCTAGGCTTACTT
TAACCTGAGTGGAATTACCAAGGGCTGAGA|TACTTATAAGAATGGTATTCAAATGCGGCC
AGAACAGCTCAGTACCTTGAGCCGCAGGTG|ATTACCAAGGGCTGAGAACAGCTCAAAGCA
GCTATTGCGTGTAAATTTGTTCAGTGCATA|AAGGGCTGAGAACAGCTCATTCTAGGCTTA
AATTACCAAGGGCTGAGAACAGCTCATTCT|GAACAGCTCAGGTGTGGGTGGAATTACCAA
ATTGACACAATGTGTTGAGTCTTGCCTCGA|TCGACAATTTTTATCCAAGATTCCCAGATA
GGCGTGGAATTACCAAGGGTGGAATTACCA|TCTCTAGCTATGGAAATCTCACTACTCTCC
AGGTTTCAGAAAGACCCCTCCACGCGAGAA|CCTTTGAGCTACGGTTAAGGGAGTACTGGT
TCGTCGGCATATTCGGTGGAAGGCAAACTT|TGAACGGGTAGTACCACCACGGAAATATCC
TTTCAGAAAGACCCCTCCACGCGAGAAGGT|TTGAGCTACGGTTAAGGGAGTACTGGTTGG
TACCAAGGGCTGAGAACAGCTCAAATTACC|CTCAGCTCAACCAAGGGCTGAGAACAGCTC
ACTTTGTCTTGTCCTAGGACTACGACGTAA|ATCCTATTGACACAATGTGTTGAGTCTTGC
TCCTAGAAAAGTCGACAATTTTTATCCAAG|AGAGGGAGTGGAATTACCAAGGGCTGAGAA
CAAGGGCTGAGAACAGCTCAGAGACCTAAC|CCACGGAAACCAGTGAAGCTTCGATAACAC
CCGTTCTTTGCAATATAAACCTTGCCAAAA|GAACAGCTCATCATACCGATCCATGAGGAC
CTGAGAACAGCTCAAATTACCAAGGGCTGA|TAGGGATCAGGTTTCAGAAAGACCCCTCCA
GATGAGGTGGGAAGTGTCTGAAGTGGAATT|GGGCTGAGAACAGCTCAGCTGAGAACAGCT
TACCAAGGGCTGAGAACAGTGGAATTACCA|GCTCATGACTAAGCTACTGCCTATTGGTAC
CACGTTGTTAAGTGGAATTACCAAGGGCTG|TTTGTCATAATAATTAATTCGCGGCCCGCT
AACCCACCTCTGTATCATCTGCTGGGGTGT|CACTAGAGTCATGGGATTTCGTCGGCACGG
TATCCAAGATTCCCAGATACTACAAGTGGA|GCTGAGAACAGCTCAGTACCTTGAGCCGCA
ATGGGATGAGGTGGGAAGTGTCTGAAGTGG|CCAAGGGCTGAGAACAGCTCAGCTGAGAAC
ACAGCTCAGCTGAGAACAGCTCATGAGAAC|CGGCATATTCGGTGGAAGGCAAACTTTGTC
AATTACCAAGGGCTGAGAACAGCTCAGAGA|AGGTGTCCACGGAAACCAGTGAAGCTTCGA
AGCTATGGAAATCTCACTACTCTCCGAGTT|ATATAAACCTTGCCAAAAGCTTATGCGGTA
TCATGACTAAGCTACTGCCTATTGGTACAG|CAGTTCAGAACCAGTAGCTGTACCCGTTCT
TTACTTATAAGAATGGTATTCAAATGCGGC|TGAGAACAGCTCAAATTACCAAGGGCTGAG
CTCACTACTCTCCGAGTTGTCGTCGGCATA|CCAAAAGCTTATGCGGTAGTGAACGGGTAG
AGAACAGCTCAGCTGAGAACAGCTCATGAG|CGTCGGCATATTCGGTGGAAGGCAAACTTT
GCGTCGAAGTCCTAGACGCTATAGGGATCA|TAAATATTTTATCATGCGCACAGGTCAGTC
TTAACCGCAACTTTGTCATAATAATTAATT|ACAGCTCACATTCATGCTGAGGAGGGGGGG
AGGCAAACTTTGTCTTGTCCTAGGACTACG|GGAAATATCCTATTGACACAATGTGTTGAG
ACCTAACCCACCTCTGTATCATCTGCTGGG|ATAACACTAGAGTCATGGGATTTCGTCGGC
CAAAGCAGCGCTTCTCTTACTTATGGGATG|GGAATTACCAAGGGTGGAATTACCAAGGGC
GGCTGAGAACAGCTCAAATCTGATCGTGGA|CCGCTATGGGTGGAATTACCAAGGGCTGAG
TAGTACCACCACGGAAATATCCTATTGACA|GTCTCGTGAGACTCCTAGAAAAGTCGACAA
AATTACCAAGGGCTGAGAACAGCTCATCAT|AATTACCAAGGGCTGAGAACAGCTCAGAGA
CAAAGCACGTTGTTAAGTGGAATTACCAAG|GCAACTTTGTCATAATAATTAATTCGCGGC
AAGAATGGTATTCAAATGCGGCCTTAACCG|GCTCAAATTACCAAGGGCTGAGAACAGCTC
CCTTAACCGCAACTTTGTCATAATAATTAA|GAACAGCTCACATTCATGCTGAGGAGGGGG
TCAACCAAGGGCTGAGAACAGCTCATGACT|GGACTACGACGTAAGCGATACACAGTTCAG
AGGGCTGAGAACAGCTCAAATCTGATCGTG|GCCCGCTATGGGTGGAATTACCAAGGGCTG
AGAACAGCTCAAATTACCAAGGGCTGAGAA|GGATCAGGTTTCAGAAAGACCCCTCCACGC
AGTTAAGATATCCTAACTATTTCATCCAGA|TGTTCGCGCCGAGGGCGGCAAAGTGTGTAC
GGAAGTGTCTGAAGTGGAATTGTGGGTGGA|ACAGCTCAGCTGAGAACAGCTCATGAGAAC
GTTCAGTTAAGATATCCTAACTATTTCATC|AACCTGTTCGCGCCGAGGGCGGCAAAGTGT
CTGAGAACAGCTCAAAGCACGTTGTTAAGT|GCGGCCTTAACCGCAACTTTGTCATAATAA
CGTTCTTTGCAATATAAACCTTGCCAAAAG|AACAGCTCATCATACCGATCCATGAGGACG
CCCCTCCACGCGAGAAGGTTAACACGATAG|TTAAGGGAGTACTGGTTGGCCTTCAGGGGC
GAAGGCAAACTTTGTCTTGTCCTAGGACTA|ACGGAAATATCCTATTGACACAATGTGTTG
GAATTACCAAGGGCTGAGAACAGCTCAAAG|ATGGTATTCAAATGCGGCCTTAACCGCAAC
CTCATTCTAGGCTTACTTATAAGAATGGTA|ATTACCAAGGGCTGAGAACAGCTCAAATTA
GTGGAATTACCAAGGGTGGAATTACCAAGG|CTAGCTATGGAAATCTCACTACTCTCCGAG
GGGCTGAGAACAGCTCAAATCTGATCGTGG|CCCGCTATGGGTGGAATTACCAAGGGCTGA
TACCAAGGGCTGAGAACAGCTCAGCTGAGA|TCTCCGAGTTGTCGTCGGCATATTCGGTGG
GGGTGGAATTACCAAGGGCTGAGAACAGCT|TCCTAACTATTTCATCCAGAATGTTTTGAT
ATCATACCGATCCATGAGGACGTAGAGATA|AGAGACCTAACCCACCTCTGTATCATCTGC
GCTGAGAACAGTGGAATTACCAAGGGCGTG|CTAAGCTACTGCCTATTGGTACAGTCTCTA
GATCATTCAATCGCGAGAGGGAGTGGAATT|GCTATTGCGTGTAAATTTGTTCAGTGCATA
CGTCGGCATATTCGGTGGAAGGCAAACTTT|GAACGGGTAGTACCACCACGGAAATATCCT
AGAATGTTTTGATTCTGGCGTCGAAGTCCT|TACGGCCACGAACTAATTAAATATTTTATC
TAATTAATTCGCGGCCCGCTATGGGTGGAA|GAGGGGGGGTTCAGTTAAGATATCCTAACT
CGCAGGTGTCCACGGAAACCAGTGAAGCTT|TCAAAGCACGTTGTTAAGTGGAATTACCAA
TGTCTGAAGTGGAATTGTGGGTGGAATTAC|TCAGCTGAGAACAGCTCATGAGAACAGCTC
AAACCAGTGAAGCTTCGATAACACTAGAGT|AAGTGGAATTACCAAGGGCTGAGAACAGCT
CTTCGATAACACTAGAGTCATGGGATTTCG|CAAGGGCTGAGAACAGCTCAAATCTGATCG
CCAAGGGCTGAGAACAGCTCAAAGCACGTT|TTCAAATGCGGCCTTAACCGCAACTTTGTC
TTGTTCAGTGCATAACCTGAGTGGAATTAC|TCATTCTAGGCTTACTTATAAGAATGGTAT
TTCAAATGCGGCCTTAACCGCAACTTTGTC|CCAAGGGCTGAGAACAGCTCACATTCATGC
GTAGCTGTACCCGTTCTTTGCAATATAAAC|CAAGGGCTGAGAACAGCTCATCATACCGAT
CGTCGGCACGGGGCTATTGCGTGTAAATTT|CGTGGAATTACCAAGGGCTGAGAACAGCTC
ACCAGTAGCTGTACCCGTTCTTTGCAATAT|TTACCAAGGGCTGAGAACAGCTCATCATAC
TACCAAGGGCGTGGAATTACCAAGGGTGGA|GGTACAGTCTCTAGCTATGGAAATCTCACT
AGAACAGCTCACATTCATGCTGAGGAGGGG|ACGCGAGAAGGTTAACACGATAGCGGCTAC
TTATCCAAGATTCCCAGATACTACAAGTGG|GGCTGAGAACAGCTCAGTACCTTGAGCCGC
CTCAACCAAGGGCTGAGAACAGCTCATGAC|AGGACTACGACGTAAGCGATACACAGTTCA
GAATTACCAAGGGCTGAGAACAGCTCAAAT|GTCCTAGACGCTATAGGGATCAGGTTTCAG
GGTGGAAGGCAAACTTTGTCTTGTCCTAGG|CACCACGGAAATATCCTATTGACACAATGT
AAGGCAAACTTTGTCTTGTCCTAGGACTAC|CGGAAATATCCTATTGACACAATGTGTTGA
GGCTGAGAACAGCTCAGAGACCTAACCCAC|GGAAACCAGTGAAGCTTCGATAACACTAGA
GAAGGTTAACACGATAGCGGCTACCGAACC|GGTTGGCCTTCAGGGGCTCGATGGAAACTC
TGCCAAAAGCTTATGCGGTAGTGAACGGGT|ATGAGGACGTAGAGATACACTGAGCGCGGG
GATCAGGTTTCAGAAAGACCCCTCCACGCG|CAGTCCTTTGAGCTACGGTTAAGGGAGTAC
GCTGAGAACAGCTCAAATTACCAAGGGCTG|ATAGGGATCAGGTTTCAGAAAGACCCCTCC
GAATGGTATTCAAATGCGGCCTTAACCGCA|TCAAATTACCAAGGGCTGAGAACAGCTCAC
ATGTGTTGAGTCTTGCCTCGATGGGCTGTG|TTTATCCAAGATTCCCAGATACTACAAGTG
TAACTATTTCATCCAGAATGTTTTGATTCT|GGCGGCAAAGTGTGTACGGCCACGAACTAA
TGTGGGTGGAATTACCAAGGGCTGAGAACA|TCATGAGAACAGCTCAGCTCAACCAAGGGC
TTACCAAGGGCTGAGAACAGCTCATCATAC|TTACCAAGGGCTGAGAACAGCTCAGAGACC
GGGATTTCGTCGGCACGGGGCTATTGCGTG|ATCTGATCGTGGAATTACCAAGGGCTGAGA
GGGCTGAGAACAGCTCATGACTAAGCTACT|ACGTAAGCGATACACAGTTCAGAACCAGTA
GGCTGAGAACAGCTCATCATACCGATCCAT|GGCTGAGAACAGCTCAGAGACCTAACCCAC
TTGATCATTCAATCGCGAGAGGGAGTGGAA|GGGCTATTGCGTGTAAATTTGTTCAGTGCA
CTCAGGTGTGGGTGGAATTACCAAGGGCTG|ATTCTGGCGTCGAAGTCCTAGACGCTATAG
TTACCAAGGGCGTGGAATTACCAAGGGTGG|TGGTACAGTCTCTAGCTATGGAAATCTCAC
TACCAAGGGCTGAGAACAGCTCATTCTAGG|CAGCTCAGGTGTGGGTGGAATTACCAAGGG
CAAGGGCTGAGAACAGTGGAATTACCAAGG|CATGACTAAGCTACTGCCTATTGGTACAGT
TACCAAGGGTGGAATTACCAAGGGCTGAGA|TGGAAATCTCACTACTCTCCGAGTTGTCGT
GGATTTCGTCGGCACGGGGCTATTGCGTGT|TCTGATCGTGGAATTACCAAGGGCTGAGAA
AGTGCATAACCTGAGTGGAATTACCAAGGG|TAGGCTTACTTATAAGAATGGTATTCAAAT
ATCCTATTGACACAATGTGTTGAGTCTTGC|AAAAGTCGACAATTTTTATCCAAGATTCCC
TGAGAACAGCTCATCATACCGATCCATGAG|TGAGAACAGCTCAGAGACCTAACCCACCTC
AAGATTCCCAGATACTACAAGTGGAATTAC|GAACAGCTCAGTACCTTGAGCCGCAGGTGT
CTTAACCGCAACTTTGTCATAATAATTAAT|AACAGCTCACATTCATGCTGAGGAGGGGGG
TGTGGAATTACCAAGGGCTGAGAACAGCTC|AGTGGAATTACCAAGGGCTGAGAACAGCTC
TGTCCTAGGACTACGACGTAAGCGATACAC|ACACAATGTGTTGAGTCTTGCCTCGATGGG
ACGCGAGAAGGTTAACACGATAGCGGCTAC|AGTACTGGTTGGCCTTCAGGGGCTCGATGG
AATTACCAAGGGCTGAGAACAGTGGAATTA|ACAGCTCATGACTAAGCTACTGCCTATTGG
CGGCCTTAACCGCAACTTTGTCATAATAAT|TGAGAACAGCTCACATTCATGCTGAGGAGG
CAATCGCGAGAGGGAGTGGAATTACCAAGG|CGTGTAAATTTGTTCAGTGCATAACCTGAG
TTCTTTGCAATATAAACCTTGCCAAAAGCT|CAGCTCATCATACCGATCCATGAGGACGTA
GAACAGCTCAGAGACCTAACCCACCTCTGT|CAGTGAAGCTTCGATAACACTAGAGTCATG
ACCAAGGGCTGAGAACAGCTCAGGTGTGGG|TTCATCCAGAATGTTTTGATTCTGGCGTCG
CCTAGGACTACGACGTAAGCGATACACAGT|CAATGTGTTGAGTCTTGCCTCGATGGGCTG
AGTGGAATTACCAAGGGCTGAGAACAGCTC|AAGAATGGTATTCAAATGCGGCCTTAACCG
GGGAGTGGAATTACCAAGGGCTGAGAACAG|GTTCAGTGCATAACCTGAGTGGAATTACCA
GCTCATGAGAACAGCTCAGCTCAACCAAGG|GCAAACTTTGTCTTGTCCTAGGACTACGAC
CTATTTCATCCAGAATGTTTTGATTCTGGC|GGCAAAGTGTGTACGGCCACGAACTAATTA
CCAAGGGCTGAGAACAGCTCATCATACCGA|CCAAGGGCTGAGAACAGCTCAGAGACCTAA
GCTGAGAACAGCTCAAATCTGATCGTGGAA|CGCTATGGGTGGAATTACCAAGGGCTGAGA
AAATCTGATCGTGGAATTACCAAGGGCTGA|TTACCAAGGGCTGAGAACAGCTCAGGTGTG
CTAGAGTCATGGGATTTCGTCGGCACGGGG|AACAGCTCAAATCTGATCGTGGAATTACCA
TCATCCAGAATGTTTTGATTCTGGCGTCGA|AGTGTGTACGGCCACGAACTAATTAAATAT
GCGCTTCTCTTACTTATGGGATGAGGTGGG|CCAAGGGTGGAATTACCAAGGGCTGAGAAC
AACAGCTCATGAGAACAGCTCAGCTCAACC|GAAGGCAAACTTTGTCTTGTCCTAGGACTA
CTGAGGAGGGGGGGTTCAGTTAAGATATCC|ATAGCGGCTACCGAACCTGTTCGCGCCGAG
AGGGATCAGGTTTCAGAAAGACCCCTCCAC|GGTCAGTCCTTTGAGCTACGGTTAAGGGAG
GCATATTCGGTGGAAGGCAAACTTTGTCTT|GGTAGTACCACCACGGAAATATCCTATTGA
CTATTGGTACAGTCTCTAGCTATGGAAATC|TGTACCCGTTCTTTGCAATATAAACCTTGC
GGGTTCAGTTAAGATATCCTAACTATTTCA|CGAACCTGTTCGCGCCGAGGGCGGCAAAGT
AATTACCAAGGGCTGAGAACAGCTCAGCTG|TACTCTCCGAGTTGTCGTCGGCATATTCGG
GGCTGAGAACAGCTCAGGTGTGGGTGGAAT|CAGAATGTTTTGATTCTGGCGTCGAAGTCC
CTCCACGCGAGAAGGTTAACACGATAGCGG|AGGGAGTACTGGTTGGCCTTCAGGGGCTCG
GTCTCTAGCTATGGAAATCTCACTACTCTC|TTTGCAATATAAACCTTGCCAAAAGCTTAT
TCGGCACGGGGCTATTGCGTGTAAATTTGT|TGGAATTACCAAGGGCTGAGAACAGCTCAT
TATGGAAATCTCACTACTCTCCGAGTTGTC|TAAACCTTGCCAAAAGCTTATGCGGTAGTG
GTGGAATTACCAAGGGCTGAGAACAGCTCA|GTGGAATTACCAAGGGCTGAGAACAGCTCA
ATGGTATTCAAATGCGGCCTTAACCGCAAC|AAATTACCAAGGGCTGAGAACAGCTCACAT
GGAAACCAGTGAAGCTTCGATAACACTAGA|TTAAGTGGAATTACCAAGGGCTGAGAACAG
GAGTGGAATTACCAAGGGCTGAGAACAGCT|TAAGAATGGTATTCAAATGCGGCCTTAACC
GAACAGTGGAATTACCAAGGGCGTGGAATT|CTACTGCCTATTGGTACAGTCTCTAGCTAT
TGAGGAGGGGGGGTTCAGTTAAGATATCCT|TAGCGGCTACCGAACCTGTTCGCGCCGAGG
CATCCAGAATGTTTTGATTCTGGCGTCGAA|GTGTGTACGGCCACGAACTAATTAAATATT
TGGAATTACCAAGGGCGTGGAATTACCAAG|CCTATTGGTACAGTCTCTAGCTATGGAAAT
GGAATTACCAAGGGCTGAGAACAGCTCATT|GAGAACAGCTCAGGTGTGGGTGGAATTACC
GTATTCAAATGCGGCCTTAACCGCAACTTT|TTACCAAGGGCTGAGAACAGCTCACATTCA
TGAGGTGGGAAGTGTCTGAAGTGGAATTGT|GCTGAGAACAGCTCAGCTGAGAACAGCTCA
CTTTGTCATAATAATTAATTCGCGGCCCGC|TTCATGCTGAGGAGGGGGGGTTCAGTTAAG
TGGGGTGTTGATCATTCAATCGCGAGAGGG|CGGCACGGGGCTATTGCGTGTAAATTTGTT
CGTAAGCGATACACAGTTCAGAACCAGTAG|CTTGCCTCGATGGGCTGTGGAATTACCAAG
ACCACGGAAATATCCTATTGACACAATGTG|GAGACTCCTAGAAAAGTCGACAATTTTTAT
TACCAAGGGCTGAGAACAGCTCAGGTGTGG|TTTCATCCAGAATGTTTTGATTCTGGCGTC
TAAGTGGAATTACCAAGGGCTGAGAACAGC|AATAATTAATTCGCGGCCCGCTATGGGTGG
GGGTGGAATTACCAAGGGCTGAGAACAGCT|TGAGAACAGCTCAGCTCAACCAAGGGCTGA
GTGGAATTACCAAGGGCTGAGAACAGCTCA|AGTGCATAACCTGAGTGGAATTACCAAGGG
CTGAGAACAGCTCATCATACCGATCCATGA|CTGAGAACAGCTCAGAGACCTAACCCACCT
GTGGAATTACCAAGGGCTGAGAACAGCTCA|AATTAATTCGCGGCCCGCTATGGGTGGAAT
TGCAATATAAACCTTGCCAAAAGCTTATGC|CATCATACCGATCCATGAGGACGTAGAGAT
ACCTTGCCAAAAGCTTATGCGGTAGTGAAC|ATCCATGAGGACGTAGAGATACACTGAGCG
GAACAGCTCATGACTAAGCTACTGCCTATT|CGATACACAGTTCAGAACCAGTAGCTGTAC
AAGTGGAATTACCAAGGGCTGAGAACAGCT|ATAATTAATTCGCGGCCCGCTATGGGTGGA
ACTAAGCTACTGCCTATTGGTACAGTCTCT|CAGAACCAGTAGCTGTACCCGTTCTTTGCA
GAAAGACCCCTCCACGCGAGAAGGTTAACA|CTACGGTTAAGGGAGTACTGGTTGGCCTTC
CGCTATAGGGATCAGGTTTCAGAAAGACCC|CGCACAGGTCAGTCCTTTGAGCTACGGTTA
GGTTTCAGAAAGACCCCTCCACGCGAGAAG|CTTTGAGCTACGGTTAAGGGAGTACTGGTT
TGGTACAGTCTCTAGCTATGGAAATCTCAC|CCCGTTCTTTGCAATATAAACCTTGCCAAA
AGCTCAGTACCTTGAGCCGCAGGTGTCCAC|CAAGGGCTGAGAACAGCTCAAAGCACGTTG
CTGCCTATTGGTACAGTCTCTAGCTATGGA|TAGCTGTACCCGTTCTTTGCAATATAAACC
ATTCATGCTGAGGAGGGGGGGTTCAGTTAA|TAACACGATAGCGGCTACCGAACCTGTTCG
AAAGCACGTTGTTAAGTGGAATTACCAAGG|CAACTTTGTCATAATAATTAATTCGCGGCC
AACAGCTCATGACTAAGCTACTGCCTATTG|GATACACAGTTCAGAACCAGTAGCTGTACC
TCCACGCGAGAAGGTTAACACGATAGCGGC|GGGAGTACTGGTTGGCCTTCAGGGGCTCGA
TGTTGATCATTCAATCGCGAGAGGGAGTGG|CGGGGCTATTGCGTGTAAATTTGTTCAGTG
AACAGCTCAGTACCTTGAGCCGCAGGTGTC|TACCAAGGGCTGAGAACAGCTCAAAGCACG
AGAACAGCTCATGACTAAGCTACTGCCTAT|GCGATACACAGTTCAGAACCAGTAGCTGTA
AAGGGCTGAGAACAGCTCAAATCTGATCGT|GGCCCGCTATGGGTGGAATTACCAAGGGCT
TGTCTTGTCCTAGGACTACGACGTAAGCGA|TATTGACACAATGTGTTGAGTCTTGCCTCG
GCTGAGAACAGCTCAGAGACCTAACCCACC|GAAACCAGTGAAGCTTCGATAACACTAGAG
ACTATTTCATCCAGAATGTTTTGATTCTGG|CGGCAAAGTGTGTACGGCCACGAACTAATT
ACTGCCTATTGGTACAGTCTCTAGCTATGG|GTAGCTGTACCCGTTCTTTGCAATATAAAC
ACGCTATAGGGATCAGGTTTCAGAAAGACC|GCGCACAGGTCAGTCCTTTGAGCTACGGTT
TCGCGGCCCGCTATGGGTGGAATTACCAAG|GTTCAGTTAAGATATCCTAACTATTTCATC
AAAAGCTTATGCGGTAGTGAACGGGTAGTA|GGACGTAGAGATACACTGAGCGCGGGTCTC
CCTCGATGGGCTGTGGAATTACCAAGGGCT|CAGATACTACAAGTGGAATTACCAAGGGCT
TCAGAGACCTAACCCACCTCTGTATCATCT|GCTTCGATAACACTAGAGTCATGGGATTTC
GTTGATCATTCAATCGCGAGAGGGAGTGGA|GGGGCTATTGCGTGTAAATTTGTTCAGTGC
GCTGAGAACAGCTCATGAGAACAGCTCAGC|TCGGTGGAAGGCAAACTTTGTCTTGTCCTA
TGGAATTACCAAGGGCTGAGAACAGCTCAT|TGAGAACAGCTCAGGTGTGGGTGGAATTAC
CTCAGTACCTTGAGCCGCAGGTGTCCACGG|AGGGCTGAGAACAGCTCAAAGCACGTTGTT
AAAGTCGACAATTTTTATCCAAGATTCCCA|GTGGAATTACCAAGGGCTGAGAACAGCTCA
AAGGGCTGAGAACAGCTCATGACTAAGCTA|CGACGTAAGCGATACACAGTTCAGAACCAG
AACTTTGTCTTGTCCTAGGACTACGACGTA|TATCCTATTGACACAATGTGTTGAGTCTTG
ATGGAAATCTCACTACTCTCCGAGTTGTCG|AAACCTTGCCAAAAGCTTATGCGGTAGTGA
ACTCCTAGAAAAGTCGACAATTTTTATCCA|CGAGAGGGAGTGGAATTACCAAGGGCTGAG
TACCAAGGGCTGAGAACAGCTCAGTACCTT|AACCTGAGTGGAATTACCAAGGGCTGAGAA
ATTACCAAGGGCTGAGAACAGCTCAGGTGT|TATTTCATCCAGAATGTTTTGATTCTGGCG
GGGGGGGTTCAGTTAAGATATCCTAACTAT|CTACCGAACCTGTTCGCGCCGAGGGCGGCA
AGGTGTCCACGGAAACCAGTGAAGCTTCGA|AAGCACGTTGTTAAGTGGAATTACCAAGGG
GTTGAGTCTTGCCTCGATGGGCTGTGGAAT|TCCAAGATTCCCAGATACTACAAGTGGAAT
TCTGAAGTGGAATTGTGGGTGGAATTACCA|AGCTGAGAACAGCTCATGAGAACAGCTCAG
CCAAGGGCTGAGAACAGCTCAAATTACCAA|CAGCTCAACCAAGGGCTGAGAACAGCTCAT
GGAATTACCAAGGGCTGAGAACAGCTCAAA|AACAGCTCAGCTCAACCAAGGGCTGAGAAC
CTCAGCTCAACCAAGGGCTGAGAACAGCTC|GTCCTAGGACTACGACGTAAGCGATACACA
GAACAGCTCAAATCTGATCGTGGAATTACC|TGGGTGGAATTACCAAGGGCTGAGAACAGC
GTCCTAGGACTACGACGTAAGCGATACACA|CACAATGTGTTGAGTCTTGCCTCGATGGGC
GAACAGCTCATGAGAACAGCTCAGCTCAAC|GGAAGGCAAACTTTGTCTTGTCCTAGGACT
CTCTGTATCATCTGCTGGGGTGTTGATCAT|GTCATGGGATTTCGTCGGCACGGGGCTATT
CTGAGAACAGCTCAGAGACCTAACCCACCT|AAACCAGTGAAGCTTCGATAACACTAGAGT
TGGAATTGTGGGTGGAATTACCAAGGGCTG|AACAGCTCATGAGAACAGCTCAGCTCAACC
TAGGACTACGACGTAAGCGATACACAGTTC|ATGTGTTGAGTCTTGCCTCGATGGGCTGTG
GTCTCGTGAGACTCCTAGAAAAGTCGACAA|CATTCAATCGCGAGAGGGAGTGGAATTACC
AAGCGATACACAGTTCAGAACCAGTAGCTG|GCCTCGATGGGCTGTGGAATTACCAAGGGC
ACAGCTCAAATCTGATCGTGGAATTACCAA|GGTGGAATTACCAAGGGCTGAGAACAGCTC
CAAGGGCTGAGAACAGCTCAGTACCTTGAG|CTGAGTGGAATTACCAAGGGCTGAGAACAG
TGTAAATTTGTTCAGTGCATAACCTGAGTG|GAACAGCTCATTCTAGGCTTACTTATAAGA
GTGAACGGGTAGTACCACCACGGAAATATC|TGAGCGCGGGTCTCGTGAGACTCCTAGAAA
CAATATAAACCTTGCCAAAAGCTTATGCGG|TCATACCGATCCATGAGGACGTAGAGATAC
AAAGCTTATGCGGTAGTGAACGGGTAGTAC|GACGTAGAGATACACTGAGCGCGGGTCTCG
CGTAGAGATACACTGAGCGCGGGTCTCGTG|TATCATCTGCTGGGGTGTTGATCATTCAAT
ATGCGGCCTTAACCGCAACTTTGTCATAAT|GGCTGAGAACAGCTCACATTCATGCTGAGG
AATTACCAAGGGCTGAGAACAGCTCACATT|CAGAAAGACCCCTCCACGCGAGAAGGTTAA
CGACAATTTTTATCCAAGATTCCCAGATAC|ATTACCAAGGGCTGAGAACAGCTCAGTACC
AAATGCGGCCTTAACCGCAACTTTGTCATA|AGGGCTGAGAACAGCTCACATTCATGCTGA
TAACCCACCTCTGTATCATCTGCTGGGGTG|ACACTAGAGTCATGGGATTTCGTCGGCACG
GGGGCTATTGCGTGTAAATTTGTTCAGTGC|ACCAAGGGCTGAGAACAGCTCATTCTAGGC
TGAGAACAGCTCAAAGCACGTTGTTAAGTG|CGGCCTTAACCGCAACTTTGTCATAATAAT
AAGTGGAATTGTGGGTGGAATTACCAAGGG|GAGAACAGCTCATGAGAACAGCTCAGCTCA
TCCACGGAAACCAGTGAAGCTTCGATAACA|CGTTGTTAAGTGGAATTACCAAGGGCTGAG
GAACAGCTCACATTCATGCTGAGGAGGGGG|CGCGAGAAGGTTAACACGATAGCGGCTACC
CTAGGCTTACTTATAAGAATGGTATTCAAA|AAGGGCTGAGAACAGCTCAAATTACCAAGG
TTACCAAGGGCTGAGAACAGCTCAAATTAC|GCTCAGCTCAACCAAGGGCTGAGAACAGCT
GTATCATCTGCTGGGGTGTTGATCATTCAA|TGGGATTTCGTCGGCACGGGGCTATTGCGT
CTCAAATTACCAAGGGCTGAGAACAGTGGA|GAGAACAGCTCATGACTAAGCTACTGCCTA
GGCTGAGAACAGCTCAGCTGAGAACAGCTC|GTTGTCGTCGGCATATTCGGTGGAAGGCAA
AATATCCTATTGACACAATGTGTTGAGTCT|TAGAAAAGTCGACAATTTTTATCCAAGATT
CATGACTAAGCTACTGCCTATTGGTACAGT|AGTTCAGAACCAGTAGCTGTACCCGTTCTT
TGAGAACAGCTCACATTCATGCTGAGGAGG|CCACGCGAGAAGGTTAACACGATAGCGGCT
AAGCAGCGCTTCTCTTACTTATGGGATGAG|AATTACCAAGGGTGGAATTACCAAGGGCTG
CTCAGAGACCTAACCCACCTCTGTATCATC|AGCTTCGATAACACTAGAGTCATGGGATTT
TCATACCGATCCATGAGGACGTAGAGATAC|GAGACCTAACCCACCTCTGTATCATCTGCT
CGGTGGAAGGCAAACTTTGTCTTGTCCTAG|CCACCACGGAAATATCCTATTGACACAATG
ATGAGGACGTAGAGATACACTGAGCGCGGG|ACCTCTGTATCATCTGCTGGGGTGTTGATC
CTATGGGTGGAATTACCAAGGGCTGAGAAC|GATATCCTAACTATTTCATCCAGAATGTTT
AAGGGCGTGGAATTACCAAGGGTGGAATTA|CAGTCTCTAGCTATGGAAATCTCACTACTC
GAAGTGGAATTGTGGGTGGAATTACCAAGG|TGAGAACAGCTCATGAGAACAGCTCAGCTC
ACCAAGGGCTGAGAACAGCTCAGTACCTTG|ACCTGAGTGGAATTACCAAGGGCTGAGAAC
GGCTGAGAACAGTGGAATTACCAAGGGCGT|ACTAAGCTACTGCCTATTGGTACAGTCTCT
CTTATGGGATGAGGTGGGAAGTGTCTGAAG|TTACCAAGGGCTGAGAACAGCTCAGCTGAG
CCAAGGGCTGAGAACAGCTCAGGTGTGGGT|TCATCCAGAATGTTTTGATTCTGGCGTCGA
AAACTTTGTCTTGTCCTAGGACTACGACGT|ATATCCTATTGACACAATGTGTTGAGTCTT
CAAGGGCTGAGAACAGCTCATTCTAGGCTT|CTCAGGTGTGGGTGGAATTACCAAGGGCTG
AGCTCATGAGAACAGCTCAGCTCAACCAAG|GGCAAACTTTGTCTTGTCCTAGGACTACGA
CTCGATGGGCTGTGGAATTACCAAGGGCTG|AGATACTACAAGTGGAATTACCAAGGGCTG
TATAAGAATGGTATTCAAATGCGGCCTTAA|ACAGCTCAAATTACCAAGGGCTGAGAACAG
CAGCTCAGGTGTGGGTGGAATTACCAAGGG|TTGATTCTGGCGTCGAAGTCCTAGACGCTA
AAATTTGTTCAGTGCATAACCTGAGTGGAA|CAGCTCATTCTAGGCTTACTTATAAGAATG
AATTCGCGGCCCGCTATGGGTGGAATTACC|GGGGTTCAGTTAAGATATCCTAACTATTTC
CTTATAAGAATGGTATTCAAATGCGGCCTT|GAACAGCTCAAATTACCAAGGGCTGAGAAC
GTGGAATTACCAAGGGCTGAGAACAGCTCA|TCACTACTCTCCGAGTTGTCGTCGGCATAT
TACCCGTTCTTTGCAATATAAACCTTGCCA|TGAGAACAGCTCATCATACCGATCCATGAG
AGGGCTGAGAACAGCTCAGCTGAGAACAGC|GAGTTGTCGTCGGCATATTCGGTGGAAGGC
TCAAATTACCAAGGGCTGAGAACAGTGGAA|AGAACAGCTCATGACTAAGCTACTGCCTAT
GTAGTACCACCACGGAAATATCCTATTGAC|GGTCTCGTGAGACTCCTAGAAAAGTCGACA
CTTGCCAAAAGCTTATGCGGTAGTGAACGG|CCATGAGGACGTAGAGATACACTGAGCGCG
GAAGCTTCGATAACACTAGAGTCATGGGAT|TTACCAAGGGCTGAGAACAGCTCAAATCTG
ATTACCAAGGGCTGAGAACAGCTCAGAGAC|GGTGTCCACGGAAACCAGTGAAGCTTCGAT
TTTGTCTTGTCCTAGGACTACGACGTAAGC|CCTATTGACACAATGTGTTGAGTCTTGCCT
ATAAGAATGGTATTCAAATGCGGCCTTAAC|CAGCTCAAATTACCAAGGGCTGAGAACAGC
AGTCTCTAGCTATGGAAATCTCACTACTCT|CTTTGCAATATAAACCTTGCCAAAAGCTTA
GCTTCGATAACACTAGAGTCATGGGATTTC|CCAAGGGCTGAGAACAGCTCAAATCTGATC
ACGATAGCGGCTACCGAACCTGTTCGCGCC|CAGGGGCTCGATGGAAACTCGAAAAGATGC
TGATTCTGGCGTCGAAGTCCTAGACGCTAT|GAACTAATTAAATATTTTATCATGCGCACA
TTCATGCTGAGGAGGGGGGGTTCAGTTAAG|AACACGATAGCGGCTACCGAACCTGTTCGC
GGCTGAGAACAGCTCAAATTACCAAGGGCT|TATAGGGATCAGGTTTCAGAAAGACCCCTC
CATTCTAGGCTTACTTATAAGAATGGTATT|TACCAAGGGCTGAGAACAGCTCAAATTACC
TGAGAACAGCTCAGCTCAACCAAGGGCTGA|CTTTGTCTTGTCCTAGGACTACGACGTAAG
GGATGAGGTGGGAAGTGTCTGAAGTGGAAT|AGGGCTGAGAACAGCTCAGCTGAGAACAGC
GCTCAGCTGAGAACAGCTCATGAGAACAGC|CATATTCGGTGGAAGGCAAACTTTGTCTTG
ACGGAAACCAGTGAAGCTTCGATAACACTA|TGTTAAGTGGAATTACCAAGGGCTGAGAAC
GGGCTGAGAACAGCTCACATTCATGCTGAG|CCCTCCACGCGAGAAGGTTAACACGATAGC
ACTTATAAGAATGGTATTCAAATGCGGCCT|AGAACAGCTCAAATTACCAAGGGCTGAGAA
GAATTACCAAGGGCTGAGAACAGCTCAGCT|CTACTCTCCGAGTTGTCGTCGGCATATTCG
GGTCTCGTGAGACTCCTAGAAAAGTCGACA|TCATTCAATCGCGAGAGGGAGTGGAATTAC
GAGCGCGGGTCTCGTGAGACTCCTAGAAAA|GTGTTGATCATTCAATCGCGAGAGGGAGTG
TCCATGAGGACGTAGAGATACACTGAGCGC|CCCACCTCTGTATCATCTGCTGGGGTGTTG
GAATTACCAAGGGCTGAGAACAGCTCAAAT|ACAGCTCAGCTCAACCAAGGGCTGAGAACA
ATCGTGGAATTACCAAGGGCTGAGAACAGC|GGGCTGAGAACAGCTCAGGTGTGGGTGGAA
ACAGCTCATGACTAAGCTACTGCCTATTGG|ATACACAGTTCAGAACCAGTAGCTGTACCC
AAGGTTAACACGATAGCGGCTACCGAACCT|GTTGGCCTTCAGGGGCTCGATGGAAACTCG
AGAACAGCTCATGAGAACAGCTCAGCTCAA|TGGAAGGCAAACTTTGTCTTGTCCTAGGAC
GGTGGAATTACCAAGGGCTGAGAACAGCTC|CGAAGTCCTAGACGCTATAGGGATCAGGTT
AACAGCTCACATTCATGCTGAGGAGGGGGG|GCGAGAAGGTTAACACGATAGCGGCTACCG
CTAACCCACCTCTGTATCATCTGCTGGGGT|AACACTAGAGTCATGGGATTTCGTCGGCAC
CTCTTACTTATGGGATGAGGTGGGAAGTGT|GTGGAATTACCAAGGGCTGAGAACAGCTCA
GACCCCTCCACGCGAGAAGGTTAACACGAT|GGTTAAGGGAGTACTGGTTGGCCTTCAGGG
AGATATCCTAACTATTTCATCCAGAATGTT|GCGCCGAGGGCGGCAAAGTGTGTACGGCCA
TGAAGTGGAATTGTGGGTGGAATTACCAAG|CTGAGAACAGCTCATGAGAACAGCTCAGCT
TGTTTTGATTCTGGCGTCGAAGTCCTAGAC|GCCACGAACTAATTAAATATTTTATCATGC
GCGCGGGTCTCGTGAGACTCCTAGAAAAGT|GTTGATCATTCAATCGCGAGAGGGAGTGGA
AAGGGCTGAGAACAGCTCATTCTAGGCTTA|TCAGGTGTGGGTGGAATTACCAAGGGCTGA
ATTACCAAGGGCTGAGAACAGCTCAGTACC|ATAACCTGAGTGGAATTACCAAGGGCTGAG
GAGAACAGCTCATCATACCGATCCATGAGG|GAGAACAGCTCAGAGACCTAACCCACCTCT
ACAGCTCAGAGACCTAACCCACCTCTGTAT|GTGAAGCTTCGATAACACTAGAGTCATGGG
TACCAAGGGCTGAGAACAGCTCAGAGACCT|TGTCCACGGAAACCAGTGAAGCTTCGATAA
GCTACTGCCTATTGGTACAGTCTCTAGCTA|CCAGTAGCTGTACCCGTTCTTTGCAATATA
AATGTGTTGAGTCTTGCCTCGATGGGCTGT|TTTTATCCAAGATTCCCAGATACTACAAGT
GTAGTGAACGGGTAGTACCACCACGGAAAT|CACTGAGCGCGGGTCTCGTGAGACTCCTAG
ACCAAGGGCGTGGAATTACCAAGGGTGGAA|GTACAGTCTCTAGCTATGGAAATCTCACTA
CCCGTTCTTTGCAATATAAACCTTGCCAAA|AGAACAGCTCATCATACCGATCCATGAGGA
GGCTGTGGAATTACCAAGGGCTGAGAACAG|ACAAGTGGAATTACCAAGGGCTGAGAACAG
GAACAGCTCAGCTCAACCAAGGGCTGAGAA|TGTCTTGTCCTAGGACTACGACGTAAGCGA
TTCAGTTAAGATATCCTAACTATTTCATCC|ACCTGTTCGCGCCGAGGGCGGCAAAGTGTG
AGCTCAGCTCAACCAAGGGCTGAGAACAGC|TTGTCCTAGGACTACGACGTAAGCGATACA
AGGCAAAGCAGCGCTTCTCTTACTTATGGG|CGTGGAATTACCAAGGGTGGAATTACCAAG
TTAAGTGGAATTACCAAGGGCTGAGAACAG|TAATAATTAATTCGCGGCCCGCTATGGGTG
AGCTTCGATAACACTAGAGTCATGGGATTT|ACCAAGGGCTGAGAACAGCTCAAATCTGAT
GGAGTGGAATTACCAAGGGCTGAGAACAGC|TTCAGTGCATAACCTGAGTGGAATTACCAA
ATGAGGTGGGAAGTGTCTGAAGTGGAATTG|GGCTGAGAACAGCTCAGCTGAGAACAGCTC
GCGAGAGGGAGTGGAATTACCAAGGGCTGA|AAATTTGTTCAGTGCATAACCTGAGTGGAA
TACCACCACGGAAATATCCTATTGACACAA|TCGTGAGACTCCTAGAAAAGTCGACAATTT
GGGCTGAGAACAGCTCAAAGCACGTTGTTA|AATGCGGCCTTAACCGCAACTTTGTCATAA
TAGAGATACACTGAGCGCGGGTCTCGTGAG|TCATCTGCTGGGGTGTTGATCATTCAATCG
TCTAGCTATGGAAATCTCACTACTCTCCGA|GCAATATAAACCTTGCCAAAAGCTTATGCG
ATTACCAAGGGCTGAGAACAGCTCACATTC|AGAAAGACCCCTCCACGCGAGAAGGTTAAC
CCCGCTATGGGTGGAATTACCAAGGGCTGA|TTAAGATATCCTAACTATTTCATCCAGAAT
CAGCTCATGAGAACAGCTCAGCTCAACCAA|AGGCAAACTTTGTCTTGTCCTAGGACTACG
TCGTGGAATTACCAAGGGCTGAGAACAGCT|GGCTGAGAACAGCTCAGGTGTGGGTGGAAT
CTACTGCCTATTGGTACAGTCTCTAGCTAT|CAGTAGCTGTACCCGTTCTTTGCAATATAA
CGGAAACCAGTGAAGCTTCGATAACACTAG|GTTAAGTGGAATTACCAAGGGCTGAGAACA
CTCGTGAGACTCCTAGAAAAGTCGACAATT|TTCAATCGCGAGAGGGAGTGGAATTACCAA
GAGCCGCAGGTGTCCACGGAAACCAGTGAA|CAGCTCAAAGCACGTTGTTAAGTGGAATTA
TTCGATAACACTAGAGTCATGGGATTTCGT|AAGGGCTGAGAACAGCTCAAATCTGATCGT
TGAGACTCCTAGAAAAGTCGACAATTTTTA|ATCGCGAGAGGGAGTGGAATTACCAAGGGC
GCGTGTAAATTTGTTCAGTGCATAACCTGA|TGAGAACAGCTCATTCTAGGCTTACTTATA
TTTGCAATATAAACCTTGCCAAAAGCTTAT|CTCATCATACCGATCCATGAGGACGTAGAG
GCCTTAACCGCAACTTTGTCATAATAATTA|AGAACAGCTCACATTCATGCTGAGGAGGGG
TAATTCGCGGCCCGCTATGGGTGGAATTAC|GGGGGTTCAGTTAAGATATCCTAACTATTT
ATTACCAAGGGTGGAATTACCAAGGGCTGA|TATGGAAATCTCACTACTCTCCGAGTTGTC
TCATTCTAGGCTTACTTATAAGAATGGTAT|TTACCAAGGGCTGAGAACAGCTCAAATTAC
GCATAACCTGAGTGGAATTACCAAGGGCTG|GCTTACTTATAAGAATGGTATTCAAATGCG
CACGGAAACCAGTGAAGCTTCGATAACACT|TTGTTAAGTGGAATTACCAAGGGCTGAGAA
GAGAACAGCTCAGGTGTGGGTGGAATTACC|ATGTTTTGATTCTGGCGTCGAAGTCCTAGA
TCCAAGATTCCCAGATACTACAAGTGGAAT|TGAGAACAGCTCAGTACCTTGAGCCGCAGG
CGCGAGAGGGAGTGGAATTACCAAGGGCTG|TAAATTTGTTCAGTGCATAACCTGAGTGGA
ATTTCATCCAGAATGTTTTGATTCTGGCGT|CAAAGTGTGTACGGCCACGAACTAATTAAA
CAAGGGCTGAGAACAGCTCAAATCTGATCG|CGGCCCGCTATGGGTGGAATTACCAAGGGC
CCACCTCTGTATCATCTGCTGGGGTGTTGA|TAGAGTCATGGGATTTCGTCGGCACGGGGC
GATACACAGTTCAGAACCAGTAGCTGTACC|CGATGGGCTGTGGAATTACCAAGGGCTGAG
TTCTCTTACTTATGGGATGAGGTGGGAAGT|GGGTGGAATTACCAAGGGCTGAGAACAGCT
GGCTATTGCGTGTAAATTTGTTCAGTGCAT|CAAGGGCTGAGAACAGCTCATTCTAGGCTT
GAGAAGGTTAACACGATAGCGGCTACCGAA|CTGGTTGGCCTTCAGGGGCTCGATGGAAAC
ACTGAGCGCGGGTCTCGTGAGACTCCTAGA|GGGGTGTTGATCATTCAATCGCGAGAGGGA
CTTATGCGGTAGTGAACGGGTAGTACCACC|TAGAGATACACTGAGCGCGGGTCTCGTGAG
AAGCTTCGATAACACTAGAGTCATGGGATT|TACCAAGGGCTGAGAACAGCTCAAATCTGA
AGCTCAAATCTGATCGTGGAATTACCAAGG|TGGAATTACCAAGGGCTGAGAACAGCTCAG
GAGAACAGCTCAAATTACCAAGGGCTGAGA|GGGATCAGGTTTCAGAAAGACCCCTCCACG
TCAGGTTTCAGAAAGACCCCTCCACGCGAG|GTCCTTTGAGCTACGGTTAAGGGAGTACTG
TGAAGCTTCGATAACACTAGAGTCATGGGA|ATTACCAAGGGCTGAGAACAGCTCAAATCT
TAAGAATGGTATTCAAATGCGGCCTTAACC|AGCTCAAATTACCAAGGGCTGAGAACAGCT
ATTACCAAGGGCTGAGAACAGCTCATCATA|ATTACCAAGGGCTGAGAACAGCTCAGAGAC
GGCTGAGAACAGCTCATTCTAGGCTTACTT|GGTGTGGGTGGAATTACCAAGGGCTGAGAA
GGGCTGAGAACAGCTCAGGTGTGGGTGGAA|CCAGAATGTTTTGATTCTGGCGTCGAAGTC
AATTACCAAGGGCTGAGAACAGCTCAGTAC|CATAACCTGAGTGGAATTACCAAGGGCTGA
ACCTTGAGCCGCAGGTGTCCACGGAAACCA|GAGAACAGCTCAAAGCACGTTGTTAAGTGG
GACGTAAGCGATACACAGTTCAGAACCAGT|GTCTTGCCTCGATGGGCTGTGGAATTACCA
TTGTCTTGTCCTAGGACTACGACGTAAGCG|CTATTGACACAATGTGTTGAGTCTTGCCTC
TTCTGGCGTCGAAGTCCTAGACGCTATAGG|CTAATTAAATATTTTATCATGCGCACAGGT
ACTTATGGGATGAGGTGGGAAGTGTCTGAA|ATTACCAAGGGCTGAGAACAGCTCAGCTGA
CAGCTCATTCTAGGCTTACTTATAAGAATG|GGAATTACCAAGGGCTGAGAACAGCTCAAA
TCATGGGATTTCGTCGGCACGGGGCTATTG|TCAAATCTGATCGTGGAATTACCAAGGGCT
AATTTTTATCCAAGATTCCCAGATACTACA|CCAAGGGCTGAGAACAGCTCAGTACCTTGA
CAGTCTCTAGCTATGGAAATCTCACTACTC|TCTTTGCAATATAAACCTTGCCAAAAGCTT
CAGGTGTCCACGGAAACCAGTGAAGCTTCG|AAAGCACGTTGTTAAGTGGAATTACCAAGG
TATTCAAATGCGGCCTTAACCGCAACTTTG|TACCAAGGGCTGAGAACAGCTCACATTCAT
GTGGAATTACCAAGGGCTGAGAACAGCTCA|AGAATGGTATTCAAATGCGGCCTTAACCGC
AATCTCACTACTCTCCGAGTTGTCGTCGGC|TTGCCAAAAGCTTATGCGGTAGTGAACGGG
CAAGGGCGTGGAATTACCAAGGGTGGAATT|ACAGTCTCTAGCTATGGAAATCTCACTACT
GAGGACGTAGAGATACACTGAGCGCGGGTC|CTCTGTATCATCTGCTGGGGTGTTGATCAT
GGCGTCGAAGTCCTAGACGCTATAGGGATC|TTAAATATTTTATCATGCGCACAGGTCAGT
CATCTGCTGGGGTGTTGATCATTCAATCGC|ATTTCGTCGGCACGGGGCTATTGCGTGTAA
CCGCAGGTGTCCACGGAAACCAGTGAAGCT|CTCAAAGCACGTTGTTAAGTGGAATTACCA
ATATCCTAACTATTTCATCCAGAATGTTTT|GCCGAGGGCGGCAAAGTGTGTACGGCCACG
TGGGTGGAATTACCAAGGGCTGAGAACAGC|GTCGAAGTCCTAGACGCTATAGGGATCAGG
ATATAAACCTTGCCAAAAGCTTATGCGGTA|ATACCGATCCATGAGGACGTAGAGATACAC
TATCATCTGCTGGGGTGTTGATCATTCAAT|GGGATTTCGTCGGCACGGGGCTATTGCGTG
GTGAAGCTTCGATAACACTAGAGTCATGGG|AATTACCAAGGGCTGAGAACAGCTCAAATC
TGGAATTACCAAGGGCTGAGAACAGCTCAA|AAGTCCTAGACGCTATAGGGATCAGGTTTC
CACGGGGCTATTGCGTGTAAATTTGTTCAG|ATTACCAAGGGCTGAGAACAGCTCATTCTA
GGTAGTACCACCACGGAAATATCCTATTGA|GGGTCTCGTGAGACTCCTAGAAAAGTCGAC
TCCTAGGACTACGACGTAAGCGATACACAG|ACAATGTGTTGAGTCTTGCCTCGATGGGCT
GGGCTGAGAACAGCTCAGAGACCTAACCCA|CGGAAACCAGTGAAGCTTCGATAACACTAG
TTTGTCATAATAATTAATTCGCGGCCCGCT|TCATGCTGAGGAGGGGGGGTTCAGTTAAGA
AGCTCAGGTGTGGGTGGAATTACCAAGGGC|TGATTCTGGCGTCGAAGTCCTAGACGCTAT
GGGTGGAATTACCAAGGGCTGAGAACAGCT|TCTCACTACTCTCCGAGTTGTCGTCGGCAT
CCATGAGGACGTAGAGATACACTGAGCGCG|CCACCTCTGTATCATCTGCTGGGGTGTTGA
AATGTTTTGATTCTGGCGTCGAAGTCCTAG|CGGCCACGAACTAATTAAATATTTTATCAT
GAGAACAGCTCAAATCTGATCGTGGAATTA|TATGGGTGGAATTACCAAGGGCTGAGAACA
ATTACCAAGGGCTGAGAACAGCTCAAATTA|CCTAGACGCTATAGGGATCAGGTTTCAGAA
CCGATCCATGAGGACGTAGAGATACACTGA|CTAACCCACCTCTGTATCATCTGCTGGGGT
TTAATTCGCGGCCCGCTATGGGTGGAATTA|GGGGGGTTCAGTTAAGATATCCTAACTATT
CGGTAGTGAACGGGTAGTACCACCACGGAA|TACACTGAGCGCGGGTCTCGTGAGACTCCT
GAATTACCAAGGGCTGAGAACAGCTCAAAT|TAATTCGCGGCCCGCTATGGGTGGAATTAC
GGGTCTCGTGAGACTCCTAGAAAAGTCGAC|ATCATTCAATCGCGAGAGGGAGTGGAATTA
GGGCTGAGAACAGCTCAAATTACCAAGGGC|TCAACCAAGGGCTGAGAACAGCTCATGACT
TTACCAAGGGCTGAGAACAGCTCAAATTAC|CTAGACGCTATAGGGATCAGGTTTCAGAAA
CACCTCTGTATCATCTGCTGGGGTGTTGAT|AGAGTCATGGGATTTCGTCGGCACGGGGCT
ATTCGCGGCCCGCTATGGGTGGAATTACCA|GGGTTCAGTTAAGATATCCTAACTATTTCA
CTAACTATTTCATCCAGAATGTTTTGATTC|GGGCGGCAAAGTGTGTACGGCCACGAACTA
GTCCACGGAAACCAGTGAAGCTTCGATAAC|ACGTTGTTAAGTGGAATTACCAAGGGCTGA
CAGCTCAGCTCAACCAAGGGCTGAGAACAG|CTTGTCCTAGGACTACGACGTAAGCGATAC
CAAGGGCTGAGAACAGCTCACATTCATGCT|GACCCCTCCACGCGAGAAGGTTAACACGAT
AGCTGTACCCGTTCTTTGCAATATAAACCT|AGGGCTGAGAACAGCTCATCATACCGATCC
GTACCACCACGGAAATATCCTATTGACACA|CTCGTGAGACTCCTAGAAAAGTCGACAATT
GCGATACACAGTTCAGAACCAGTAGCTGTA|CTCGATGGGCTGTGGAATTACCAAGGGCTG
TGGGATTTCGTCGGCACGGGGCTATTGCGT|AATCTGATCGTGGAATTACCAAGGGCTGAG
ATTACCAAGGGCTGAGAACAGCTCAAATCT|ATTCGCGGCCCGCTATGGGTGGAATTACCA
CCAAGGGCTGAGAACAGCTCATTCTAGGCT|GCTCAGGTGTGGGTGGAATTACCAAGGGCT
CTCAAATTACCAAGGGCTGAGAACAGCTCA|GTTTCAGAAAGACCCCTCCACGCGAGAAGG
AAAGACCCCTCCACGCGAGAAGGTTAACAC|TACGGTTAAGGGAGTACTGGTTGGCCTTCA
GAGAACAGCTCATGACTAAGCTACTGCCTA|AGCGATACACAGTTCAGAACCAGTAGCTGT
AATTACCAAGGGCTGAGAACAGCTCAAATT|CAGCTCAGCTCAACCAAGGGCTGAGAACAG
TTTCGTCGGCACGGGGCTATTGCGTGTAAA|GATCGTGGAATTACCAAGGGCTGAGAACAG
AATTTGTTCAGTGCATAACCTGAGTGGAAT|AGCTCATTCTAGGCTTACTTATAAGAATGG
AGGGCTGAGAACAGCTCATTCTAGGCTTAC|CAGGTGTGGGTGGAATTACCAAGGGCTGAG
GGTGTTGATCATTCAATCGCGAGAGGGAGT|CACGGGGCTATTGCGTGTAAATTTGTTCAG
AAGACCCCTCCACGCGAGAAGGTTAACACG|ACGGTTAAGGGAGTACTGGTTGGCCTTCAG
CCAAGGGCTGAGAACAGCTCAGCTGAGAAC|TCCGAGTTGTCGTCGGCATATTCGGTGGAA
TGTATCATCTGCTGGGGTGTTGATCATTCA|ATGGGATTTCGTCGGCACGGGGCTATTGCG
AACCTGAGTGGAATTACCAAGGGCTGAGAA|ACTTATAAGAATGGTATTCAAATGCGGCCT
AAAGCAGCGCTTCTCTTACTTATGGGATGA|GAATTACCAAGGGTGGAATTACCAAGGGCT
ATTCTAGGCTTACTTATAAGAATGGTATTC|ACCAAGGGCTGAGAACAGCTCAAATTACCA
TGGAAATCTCACTACTCTCCGAGTTGTCGT|AACCTTGCCAAAAGCTTATGCGGTAGTGAA
ATGGGTGGAATTACCAAGGGCTGAGAACAG|TATCCTAACTATTTCATCCAGAATGTTTTG
CTACTCTCCGAGTTGTCGTCGGCATATTCG|AAGCTTATGCGGTAGTGAACGGGTAGTACC
TTGGTACAGTCTCTAGCTATGGAAATCTCA|ACCCGTTCTTTGCAATATAAACCTTGCCAA
GGCCTTAACCGCAACTTTGTCATAATAATT|GAGAACAGCTCACATTCATGCTGAGGAGGG
TCAGTGCATAACCTGAGTGGAATTACCAAG|TCTAGGCTTACTTATAAGAATGGTATTCAA
GCAATATAAACCTTGCCAAAAGCTTATGCG|ATCATACCGATCCATGAGGACGTAGAGATA
AGAGATACACTGAGCGCGGGTCTCGTGAGA|CATCTGCTGGGGTGTTGATCATTCAATCGC
AAATTACCAAGGGCTGAGAACAGCTCACAT|TCAGAAAGACCCCTCCACGCGAGAAGGTTA
CAATTTTTATCCAAGATTCCCAGATACTAC|ACCAAGGGCTGAGAACAGCTCAGTACCTTG
GGGGGGTTCAGTTAAGATATCCTAACTATT|TACCGAACCTGTTCGCGCCGAGGGCGGCAA
AGCGCTTCTCTTACTTATGGGATGAGGTGG|ACCAAGGGTGGAATTACCAAGGGCTGAGAA
GAACAGCTCAAATTACCAAGGGCTGAGAAC|GATCAGGTTTCAGAAAGACCCCTCCACGCG
CGTGAGACTCCTAGAAAAGTCGACAATTTT|CAATCGCGAGAGGGAGTGGAATTACCAAGG
ACTACAAGTGGAATTACCAAGGGCTGAGAA|CCTTGAGCCGCAGGTGTCCACGGAAACCAG
TGAGAACAGCTCATGACTAAGCTACTGCCT|AAGCGATACACAGTTCAGAACCAGTAGCTG
CAACCAAGGGCTGAGAACAGCTCATGACTA|GACTACGACGTAAGCGATACACAGTTCAGA
GAATTGTGGGTGGAATTACCAAGGGCTGAG|CAGCTCATGAGAACAGCTCAGCTCAACCAA
CCAAGGGCTGAGAACAGCTCAGTACCTTGA|CCTGAGTGGAATTACCAAGGGCTGAGAACA
TCAGTACCTTGAGCCGCAGGTGTCCACGGA|GGGCTGAGAACAGCTCAAAGCACGTTGTTA
GTTAAGATATCCTAACTATTTCATCCAGAA|GTTCGCGCCGAGGGCGGCAAAGTGTGTACG
AGCTCATCATACCGATCCATGAGGACGTAG|AGCTCAGAGACCTAACCCACCTCTGTATCA
TTACCAAGGGCTGAGAACAGCTCAAATCTG|TTCGCGGCCCGCTATGGGTGGAATTACCAA
TTACCAAGGGCTGAGAACAGCTCATTCTAG|ACAGCTCAGGTGTGGGTGGAATTACCAAGG
TGTTGAGTCTTGCCTCGATGGGCTGTGGAA|ATCCAAGATTCCCAGATACTACAAGTGGAA
CGAAGTCCTAGACGCTATAGGGATCAGGTT|TATTTTATCATGCGCACAGGTCAGTCCTTT
AGAACAGCTCATTCTAGGCTTACTTATAAG|GGGTGGAATTACCAAGGGCTGAGAACAGCT
ACAGCTCATCATACCGATCCATGAGGACGT|ACAGCTCAGAGACCTAACCCACCTCTGTAT
TCGATGGGCTGTGGAATTACCAAGGGCTGA|GATACTACAAGTGGAATTACCAAGGGCTGA
CATCATACCGATCCATGAGGACGTAGAGAT|CAGAGACCTAACCCACCTCTGTATCATCTG
TTACCAAGGGTGGAATTACCAAGGGCTGAG|ATGGAAATCTCACTACTCTCCGAGTTGTCG
TTGAGTCTTGCCTCGATGGGCTGTGGAATT|CCAAGATTCCCAGATACTACAAGTGGAATT
ACGGGTAGTACCACCACGGAAATATCCTAT|CGCGGGTCTCGTGAGACTCCTAGAAAAGTC
TCAAATTACCAAGGGCTGAGAACAGCTCAC|TTTCAGAAAGACCCCTCCACGCGAGAAGGT
GAGAACAGCTCATGAGAACAGCTCAGCTCA|GTGGAAGGCAAACTTTGTCTTGTCCTAGGA
AATCTGATCGTGGAATTACCAAGGGCTGAG|TACCAAGGGCTGAGAACAGCTCAGGTGTGG
CACGATAGCGGCTACCGAACCTGTTCGCGC|TCAGGGGCTCGATGGAAACTCGAAAAGATG
GTTAAGTGGAATTACCAAGGGCTGAGAACA|ATAATAATTAATTCGCGGCCCGCTATGGGT
CTGAGAACAGCTCAGGTGTGGGTGGAATTA|GAATGTTTTGATTCTGGCGTCGAAGTCCTA
GTGGAATTACCAAGGGCTGAGAACAGCTCA|GAAGTCCTAGACGCTATAGGGATCAGGTTT
AATTACCAAGGGCTGAGAACAGCTCAAAGC|TGGTATTCAAATGCGGCCTTAACCGCAACT
GTGGGAAGTGTCTGAAGTGGAATTGTGGGT|AGAACAGCTCAGCTGAGAACAGCTCATGAG
ACCTGAGTGGAATTACCAAGGGCTGAGAAC|CTTATAAGAATGGTATTCAAATGCGGCCTT
ACCGATCCATGAGGACGTAGAGATACACTG|CCTAACCCACCTCTGTATCATCTGCTGGGG
GTTTCAGAAAGACCCCTCCACGCGAGAAGG|TTTGAGCTACGGTTAAGGGAGTACTGGTTG
GTGGAATTGTGGGTGGAATTACCAAGGGCT|GAACAGCTCATGAGAACAGCTCAGCTCAAC
TATTGCGTGTAAATTTGTTCAGTGCATAAC|GGGCTGAGAACAGCTCATTCTAGGCTTACT
CTAGAAAAGTCGACAATTTTTATCCAAGAT|AGGGAGTGGAATTACCAAGGGCTGAGAACA
GACGTAGAGATACACTGAGCGCGGGTCTCG|TGTATCATCTGCTGGGGTGTTGATCATTCA
AAGCTTATGCGGTAGTGAACGGGTAGTACC|ACGTAGAGATACACTGAGCGCGGGTCTCGT
AACAGCTCAGCTCAACCAAGGGCTGAGAAC|GTCTTGTCCTAGGACTACGACGTAAGCGAT
CACTACTCTCCGAGTTGTCGTCGGCATATT|AAAAGCTTATGCGGTAGTGAACGGGTAGTA
CTAAGCTACTGCCTATTGGTACAGTCTCTA|AGAACCAGTAGCTGTACCCGTTCTTTGCAA
CACGGAAATATCCTATTGACACAATGTGTT|GACTCCTAGAAAAGTCGACAATTTTTATCC
GTTTTGATTCTGGCGTCGAAGTCCTAGACG|CCACGAACTAATTAAATATTTTATCATGCG
AGAACAGCTCAAATCTGATCGTGGAATTAC|ATGGGTGGAATTACCAAGGGCTGAGAACAG
GGAATTACCAAGGGCTGAGAACAGCTCATC|GGAATTACCAAGGGCTGAGAACAGCTCAGA
AGCTCAAAGCACGTTGTTAAGTGGAATTAC|AACCGCAACTTTGTCATAATAATTAATTCG
AAATTACCAAGGGCTGAGAACAGTGGAATT|AACAGCTCATGACTAAGCTACTGCCTATTG
CGCAACTTTGTCATAATAATTAATTCGCGG|TCACATTCATGCTGAGGAGGGGGGGTTCAG
CTGAGAACAGCTCAAATTACCAAGGGCTGA|ACCAAGGGCTGAGAACAGCTCATGACTAAG
GATTTCGTCGGCACGGGGCTATTGCGTGTA|CTGATCGTGGAATTACCAAGGGCTGAGAAC
CGTGGAATTACCAAGGGCTGAGAACAGCTC|GCTGAGAACAGCTCAGGTGTGGGTGGAATT
AATTACCAAGGGCTGAGAACAGCTCAAATC|AATTCGCGGCCCGCTATGGGTGGAATTACC
CTCCTAGAAAAGTCGACAATTTTTATCCAA|GAGAGGGAGTGGAATTACCAAGGGCTGAGA
AGAATGGTATTCAAATGCGGCCTTAACCGC|CTCAAATTACCAAGGGCTGAGAACAGCTCA
CTTTGCAATATAAACCTTGCCAAAAGCTTA|GCTCATCATACCGATCCATGAGGACGTAGA
AGGGCTGAGAACAGCTCAGAGACCTAACCC|ACGGAAACCAGTGAAGCTTCGATAACACTA
ACTCTCCGAGTTGTCGTCGGCATATTCGGT|GCTTATGCGGTAGTGAACGGGTAGTACCAC
GCTGTGGAATTACCAAGGGCTGAGAACAGC|CAAGTGGAATTACCAAGGGCTGAGAACAGC
GTAAGCGATACACAGTTCAGAACCAGTAGC|TTGCCTCGATGGGCTGTGGAATTACCAAGG
TACAAGTGGAATTACCAAGGGCTGAGAACA|TTGAGCCGCAGGTGTCCACGGAAACCAGTG
TAAACCTTGCCAAAAGCTTATGCGGTAGTG|CCGATCCATGAGGACGTAGAGATACACTGA
CAAGTGGAATTACCAAGGGCTGAGAACAGC|GAGCCGCAGGTGTCCACGGAAACCAGTGAA
CTGAGAACAGTGGAATTACCAAGGGCGTGG|TAAGCTACTGCCTATTGGTACAGTCTCTAG
CGTGTAAATTTGTTCAGTGCATAACCTGAG|GAGAACAGCTCATTCTAGGCTTACTTATAA
TTACCAAGGGCTGAGAACAGCTCACATTCA|GAAAGACCCCTCCACGCGAGAAGGTTAACA
CTAGCTATGGAAATCTCACTACTCTCCGAG|CAATATAAACCTTGCCAAAAGCTTATGCGG
AGCTCAGCTGAGAACAGCTCATGAGAACAG|GCATATTCGGTGGAAGGCAAACTTTGTCTT
CGATACACAGTTCAGAACCAGTAGCTGTAC|TCGATGGGCTGTGGAATTACCAAGGGCTGA
CCGCAACTTTGTCATAATAATTAATTCGCG|CTCACATTCATGCTGAGGAGGGGGGGTTCA
GGACGTAGAGATACACTGAGCGCGGGTCTC|CTGTATCATCTGCTGGGGTGTTGATCATTC
CCGAGTTGTCGTCGGCATATTCGGTGGAAG|TGCGGTAGTGAACGGGTAGTACCACCACGG
GATATCCTAACTATTTCATCCAGAATGTTT|CGCCGAGGGCGGCAAAGTGTGTACGGCCAC
GAGAACAGCTCACATTCATGCTGAGGAGGG|CACGCGAGAAGGTTAACACGATAGCGGCTA
GCTGAGAACAGCTCATGACTAAGCTACTGC|GTAAGCGATACACAGTTCAGAACCAGTAGC
CAGTGAAGCTTCGATAACACTAGAGTCATG|GGAATTACCAAGGGCTGAGAACAGCTCAAA
CCTAGACGCTATAGGGATCAGGTTTCAGAA|ATCATGCGCACAGGTCAGTCCTTTGAGCTA
CAAATCTGATCGTGGAATTACCAAGGGCTG|ATTACCAAGGGCTGAGAACAGCTCAGGTGT
CCAGTGAAGCTTCGATAACACTAGAGTCAT|TGGAATTACCAAGGGCTGAGAACAGCTCAA
TCGTGAGACTCCTAGAAAAGTCGACAATTT|TCAATCGCGAGAGGGAGTGGAATTACCAAG
TGAGAACAGCTCAGCTGAGAACAGCTCATG|GTCGTCGGCATATTCGGTGGAAGGCAAACT
ATGTTTTGATTCTGGCGTCGAAGTCCTAGA|GGCCACGAACTAATTAAATATTTTATCATG
GCTGAGAACAGCTCATCATACCGATCCATG|GCTGAGAACAGCTCAGAGACCTAACCCACC
AAACCTTGCCAAAAGCTTATGCGGTAGTGA|CGATCCATGAGGACGTAGAGATACACTGAG
AGACCTAACCCACCTCTGTATCATCTGCTG|CGATAACACTAGAGTCATGGGATTTCGTCG
ACAGCTCATGAGAACAGCTCAGCTCAACCA|AAGGCAAACTTTGTCTTGTCCTAGGACTAC
CCTATTGGTACAGTCTCTAGCTATGGAAAT|CTGTACCCGTTCTTTGCAATATAAACCTTG
TGAGGACGTAGAGATACACTGAGCGCGGGT|CCTCTGTATCATCTGCTGGGGTGTTGATCA
CACAATGTGTTGAGTCTTGCCTCGATGGGC|AATTTTTATCCAAGATTCCCAGATACTACA
CAGCGCTTCTCTTACTTATGGGATGAGGTG|TACCAAGGGTGGAATTACCAAGGGCTGAGA
TACGACGTAAGCGATACACAGTTCAGAACC|TGAGTCTTGCCTCGATGGGCTGTGGAATTA
GCTCATCATACCGATCCATGAGGACGTAGA|GCTCAGAGACCTAACCCACCTCTGTATCAT
GGGCTGAGAACAGCTCATTCTAGGCTTACT|AGGTGTGGGTGGAATTACCAAGGGCTGAGA
TAAATTTGTTCAGTGCATAACCTGAGTGGA|ACAGCTCATTCTAGGCTTACTTATAAGAAT
GGAATTACCAAGGGCTGAGAACAGCTCAGT|TGCATAACCTGAGTGGAATTACCAAGGGCT
AGAACAGCTCAGAGACCTAACCCACCTCTG|CCAGTGAAGCTTCGATAACACTAGAGTCAT
AGACGCTATAGGGATCAGGTTTCAGAAAGA|ATGCGCACAGGTCAGTCCTTTGAGCTACGG
GATCCATGAGGACGTAGAGATACACTGAGC|AACCCACCTCTGTATCATCTGCTGGGGTGT
GTCTTGCCTCGATGGGCTGTGGAATTACCA|GATTCCCAGATACTACAAGTGGAATTACCA
TGGAATTACCAAGGGCTGAGAACAGCTCAG|CGCAGGTGTCCACGGAAACCAGTGAAGCTT
GGAATTACCAAGGGCTGAGAACAGCTCAAA|AGTCCTAGACGCTATAGGGATCAGGTTTCA
CCTTGAGCCGCAGGTGTCCACGGAAACCAG|AGAACAGCTCAAAGCACGTTGTTAAGTGGA
CGCGGCCCGCTATGGGTGGAATTACCAAGG|TTCAGTTAAGATATCCTAACTATTTCATCC
AGGGCTGAGAACAGCTCATCATACCGATCC|AGGGCTGAGAACAGCTCAGAGACCTAACCC
CCAAGGGCTGAGAACAGTGGAATTACCAAG|TCATGACTAAGCTACTGCCTATTGGTACAG
CCACGGAAATATCCTATTGACACAATGTGT|AGACTCCTAGAAAAGTCGACAATTTTTATC
AAGGGCTGAGAACAGCTCATCATACCGATC|AAGGGCTGAGAACAGCTCAGAGACCTAACC
ACAGTTCAGAACCAGTAGCTGTACCCGTTC|GGCTGTGGAATTACCAAGGGCTGAGAACAG
TTTCATCCAGAATGTTTTGATTCTGGCGTC|AAAGTGTGTACGGCCACGAACTAATTAAAT
TACTCTCCGAGTTGTCGTCGGCATATTCGG|AGCTTATGCGGTAGTGAACGGGTAGTACCA
AACCAAGGGCTGAGAACAGCTCATGACTAA|ACTACGACGTAAGCGATACACAGTTCAGAA
TGAGAACAGCTCAGAGACCTAACCCACCTC|AACCAGTGAAGCTTCGATAACACTAGAGTC
CAGTTCAGAACCAGTAGCTGTACCCGTTCT|GCTGTGGAATTACCAAGGGCTGAGAACAGC
CAAATTACCAAGGGCTGAGAACAGTGGAAT|GAACAGCTCATGACTAAGCTACTGCCTATT
GGGCTGTGGAATTACCAAGGGCTGAGAACA|TACAAGTGGAATTACCAAGGGCTGAGAACA
TGTTAAGTGGAATTACCAAGGGCTGAGAAC|CATAATAATTAATTCGCGGCCCGCTATGGG
ACCAAGGGTGGAATTACCAAGGGCTGAGAA|GGAAATCTCACTACTCTCCGAGTTGTCGTC
AGAACAGCTCAGCTCAACCAAGGGCTGAGA|TTGTCTTGTCCTAGGACTACGACGTAAGCG
GGGAAGTGTCTGAAGTGGAATTGTGGGTGG|AACAGCTCAGCTGAGAACAGCTCATGAGAA
TTAACACGATAGCGGCTACCGAACCTGTTC|GCCTTCAGGGGCTCGATGGAAACTCGAAAA
TCCCAGATACTACAAGTGGAATTACCAAGG|GCTCAGTACCTTGAGCCGCAGGTGTCCACG
GAGGAGGGGGGGTTCAGTTAAGATATCCTA|AGCGGCTACCGAACCTGTTCGCGCCGAGGG
GCTGAGAACAGCTCAGGTGTGGGTGGAATT|AGAATGTTTTGATTCTGGCGTCGAAGTCCT
ATTACCAAGGGCTGAGAACAGCTCATTCTA|AACAGCTCAGGTGTGGGTGGAATTACCAAG
TCAAAGCACGTTGTTAAGTGGAATTACCAA|CGCAACTTTGTCATAATAATTAATTCGCGG
GGGATCAGGTTTCAGAAAGACCCCTCCACG|GTCAGTCCTTTGAGCTACGGTTAAGGGAGT
ATTTGTTCAGTGCATAACCTGAGTGGAATT|GCTCATTCTAGGCTTACTTATAAGAATGGT
AGCTCAAATTACCAAGGGCTGAGAACAGCT|AGGTTTCAGAAAGACCCCTCCACGCGAGAA
CATGAGGACGTAGAGATACACTGAGCGCGG|CACCTCTGTATCATCTGCTGGGGTGTTGAT
TAGGCAAAGCAGCGCTTCTCTTACTTATGG|GCGTGGAATTACCAAGGGTGGAATTACCAA
GGTATTCAAATGCGGCCTTAACCGCAACTT|ATTACCAAGGGCTGAGAACAGCTCACATTC
TCATTCAATCGCGAGAGGGAGTGGAATTAC|TATTGCGTGTAAATTTGTTCAGTGCATAAC
CAGCTCAACCAAGGGCTGAGAACAGCTCAT|CCTAGGACTACGACGTAAGCGATACACAGT
TCTCGTGAGACTCCTAGAAAAGTCGACAAT|ATTCAATCGCGAGAGGGAGTGGAATTACCA
CTGTATCATCTGCTGGGGTGTTGATCATTC|CATGGGATTTCGTCGGCACGGGGCTATTGC
GATAACACTAGAGTCATGGGATTTCGTCGG|GGCTGAGAACAGCTCAAATCTGATCGTGGA
CATTCAATCGCGAGAGGGAGTGGAATTACC|ATTGCGTGTAAATTTGTTCAGTGCATAACC
GTGAGACTCCTAGAAAAGTCGACAATTTTT|AATCGCGAGAGGGAGTGGAATTACCAAGGG
GACGCTATAGGGATCAGGTTTCAGAAAGAC|TGCGCACAGGTCAGTCCTTTGAGCTACGGT
TCCTAGACGCTATAGGGATCAGGTTTCAGA|TATCATGCGCACAGGTCAGTCCTTTGAGCT
GCGTGGAATTACCAAGGGTGGAATTACCAA|CTCTAGCTATGGAAATCTCACTACTCTCCG
CTGAGTGGAATTACCAAGGGCTGAGAACAG|TATAAGAATGGTATTCAAATGCGGCCTTAA
AGGTGTGGGTGGAATTACCAAGGGCTGAGA|CTGGCGTCGAAGTCCTAGACGCTATAGGGA
CAGCTCAAATCTGATCGTGGAATTACCAAG|GTGGAATTACCAAGGGCTGAGAACAGCTCA
GTACCTTGAGCCGCAGGTGTCCACGGAAAC|CTGAGAACAGCTCAAAGCACGTTGTTAAGT
GGGCTGAGAACAGCTCAGTACCTTGAGCCG|AGTGGAATTACCAAGGGCTGAGAACAGCTC
TGAGAACAGCTCATTCTAGGCTTACTTATA|GTGGGTGGAATTACCAAGGGCTGAGAACAG
GCTATGGGTGGAATTACCAAGGGCTGAGAA|AGATATCCTAACTATTTCATCCAGAATGTT
ACAGCTCAAATTACCAAGGGCTGAGAACAG|GGCTGAGAACAGCTCATGACTAAGCTACTG
CACCACGGAAATATCCTATTGACACAATGT|TGAGACTCCTAGAAAAGTCGACAATTTTTA
TCGGCATATTCGGTGGAAGGCAAACTTTGT|ACGGGTAGTACCACCACGGAAATATCCTAT
GCCCGCTATGGGTGGAATTACCAAGGGCTG|GTTAAGATATCCTAACTATTTCATCCAGAA
GTGTCTGAAGTGGAATTGTGGGTGGAATTA|CTCAGCTGAGAACAGCTCATGAGAACAGCT
TGAACGGGTAGTACCACCACGGAAATATCC|GAGCGCGGGTCTCGTGAGACTCCTAGAAAA
TGGAATTACCAAGGGCTGAGAACAGCTCAG|TAACTATTTCATCCAGAATGTTTTGATTCT
CAGCTCAAATTACCAAGGGCTGAGAACAGT|GCTGAGAACAGCTCATGACTAAGCTACTGC
GCGGCCTTAACCGCAACTTTGTCATAATAA|CTGAGAACAGCTCACATTCATGCTGAGGAG
ACCAAGGGCTGAGAACAGCTCAAATCTGAT|CGCGGCCCGCTATGGGTGGAATTACCAAGG
GAGGTGGGAAGTGTCTGAAGTGGAATTGTG|CTGAGAACAGCTCAGCTGAGAACAGCTCAT
AGTGAAGCTTCGATAACACTAGAGTCATGG|GAATTACCAAGGGCTGAGAACAGCTCAAAT
TCTTGCCTCGATGGGCTGTGGAATTACCAA|ATTCCCAGATACTACAAGTGGAATTACCAA
CCACGGAAACCAGTGAAGCTTCGATAACAC|GTTGTTAAGTGGAATTACCAAGGGCTGAGA
CGCGAGAAGGTTAACACGATAGCGGCTACC|GTACTGGTTGGCCTTCAGGGGCTCGATGGA
TTACCAAGGGCTGAGAACAGCTCAGAGACC|GTGTCCACGGAAACCAGTGAAGCTTCGATA
CTGGGGTGTTGATCATTCAATCGCGAGAGG|TCGGCACGGGGCTATTGCGTGTAAATTTGT
TTGCAATATAAACCTTGCCAAAAGCTTATG|TCATCATACCGATCCATGAGGACGTAGAGA
GAGGGGGGGTTCAGTTAAGATATCCTAACT|GGCTACCGAACCTGTTCGCGCCGAGGGCGG
ACTACTCTCCGAGTTGTCGTCGGCATATTC|AAAGCTTATGCGGTAGTGAACGGGTAGTAC
AGAAAGACCCCTCCACGCGAGAAGGTTAAC|GCTACGGTTAAGGGAGTACTGGTTGGCCTT
GAGATACACTGAGCGCGGGTCTCGTGAGAC|ATCTGCTGGGGTGTTGATCATTCAATCGCG
AGCTACTGCCTATTGGTACAGTCTCTAGCT|ACCAGTAGCTGTACCCGTTCTTTGCAATAT
TAATAATTAATTCGCGGCCCGCTATGGGTG|GAGGAGGGGGGGTTCAGTTAAGATATCCTA
CAAACTTTGTCTTGTCCTAGGACTACGACG|AATATCCTATTGACACAATGTGTTGAGTCT
AGTCATGGGATTTCGTCGGCACGGGGCTAT|GCTCAAATCTGATCGTGGAATTACCAAGGG
CCTATTGACACAATGTGTTGAGTCTTGCCT|AAGTCGACAATTTTTATCCAAGATTCCCAG
CTAGACGCTATAGGGATCAGGTTTCAGAAA|TCATGCGCACAGGTCAGTCCTTTGAGCTAC
TGGGATGAGGTGGGAAGTGTCTGAAGTGGA|CAAGGGCTGAGAACAGCTCAGCTGAGAACA
AAGGGCTGAGAACAGCTCAGGTGTGGGTGG|ATCCAGAATGTTTTGATTCTGGCGTCGAAG
GGATCAGGTTTCAGAAAGACCCCTCCACGC|TCAGTCCTTTGAGCTACGGTTAAGGGAGTA
GCAAAGCAGCGCTTCTCTTACTTATGGGAT|TGGAATTACCAAGGGTGGAATTACCAAGGG
AGAAAAGTCGACAATTTTTATCCAAGATTC|GGAGTGGAATTACCAAGGGCTGAGAACAGC
TTTGATTCTGGCGTCGAAGTCCTAGACGCT|ACGAACTAATTAAATATTTTATCATGCGCA
CAAAAGCTTATGCGGTAGTGAACGGGTAGT|AGGACGTAGAGATACACTGAGCGCGGGTCT
GGTAGTGAACGGGTAGTACCACCACGGAAA|ACACTGAGCGCGGGTCTCGTGAGACTCCTA
GCTGAGAACAGCTCATTCTAGGCTTACTTA|GTGTGGGTGGAATTACCAAGGGCTGAGAAC
TTGACACAATGTGTTGAGTCTTGCCTCGAT|CGACAATTTTTATCCAAGATTCCCAGATAC
TAAGCTACTGCCTATTGGTACAGTCTCTAG|GAACCAGTAGCTGTACCCGTTCTTTGCAAT
GATCGTGGAATTACCAAGGGCTGAGAACAG|AGGGCTGAGAACAGCTCAGGTGTGGGTGGA
AACAGCTCAAATTACCAAGGGCTGAGAACA|GGGCTGAGAACAGCTCATGACTAAGCTACT
ATTACCAAGGGCTGAGAACAGCTCAAAGCA|GGTATTCAAATGCGGCCTTAACCGCAACTT
GCCTCGATGGGCTGTGGAATTACCAAGGGC|CCAGATACTACAAGTGGAATTACCAAGGGC
AAGGGCTGAGAACAGCTCACATTCATGCTG|ACCCCTCCACGCGAGAAGGTTAACACGATA
TCGACAATTTTTATCCAAGATTCCCAGATA|AATTACCAAGGGCTGAGAACAGCTCAGTAC
GAGACCTAACCCACCTCTGTATCATCTGCT|TCGATAACACTAGAGTCATGGGATTTCGTC
GGTGGAATTACCAAGGGCTGAGAACAGCTC|GAGAACAGCTCAGCTCAACCAAGGGCTGAG
ACCACCACGGAAATATCCTATTGACACAAT|CGTGAGACTCCTAGAAAAGTCGACAATTTT
AGTGAACGGGTAGTACCACCACGGAAATAT|CTGAGCGCGGGTCTCGTGAGACTCCTAGAA
TTTTATCCAAGATTCCCAGATACTACAAGT|AGGGCTGAGAACAGCTCAGTACCTTGAGCC
AGCGGCTACCGAACCTGTTCGCGCCGAGGG|GCTCGATGGAAACTCGAAAAGATGCGTATA
ATGGGCTGTGGAATTACCAAGGGCTGAGAA|ACTACAAGTGGAATTACCAAGGGCTGAGAA
CAGCTCAGCTGAGAACAGCTCATGAGAACA|GGCATATTCGGTGGAAGGCAAACTTTGTCT
TTACCAAGGGCTGAGAACAGTGGAATTACC|AGCTCATGACTAAGCTACTGCCTATTGGTA
CTGAGCGCGGGTCTCGTGAGACTCCTAGAA|GGGTGTTGATCATTCAATCGCGAGAGGGAG
TGAGTCTTGCCTCGATGGGCTGTGGAATTA|CAAGATTCCCAGATACTACAAGTGGAATTA
TGGGTGGAATTACCAAGGGCTGAGAACAGC|ATCCTAACTATTTCATCCAGAATGTTTTGA
GAGAACAGCTCAAATTACCAAGGGCTGAGA|CAAGGGCTGAGAACAGCTCATGACTAAGCT
AGCTCACATTCATGCTGAGGAGGGGGGGTT|AGAAGGTTAACACGATAGCGGCTACCGAAC
CGGCTACCGAACCTGTTCGCGCCGAGGGCG|TCGATGGAAACTCGAAAAGATGCGTATACC
TAGCTGTACCCGTTCTTTGCAATATAAACC|AAGGGCTGAGAACAGCTCATCATACCGATC
GCTGAGAACAGCTCAAAGCACGTTGTTAAG|TGCGGCCTTAACCGCAACTTTGTCATAATA
TGAGCCGCAGGTGTCCACGGAAACCAGTGA|ACAGCTCAAAGCACGTTGTTAAGTGGAATT
CAGCTCAGTACCTTGAGCCGCAGGTGTCCA|CCAAGGGCTGAGAACAGCTCAAAGCACGTT
AATTAATTCGCGGCCCGCTATGGGTGGAAT|AGGGGGGGTTCAGTTAAGATATCCTAACTA
GACACAATGTGTTGAGTCTTGCCTCGATGG|ACAATTTTTATCCAAGATTCCCAGATACTA
TCATCATACCGATCCATGAGGACGTAGAGA|TCAGAGACCTAACCCACCTCTGTATCATCT
CATAATAATTAATTCGCGGCCCGCTATGGG|CTGAGGAGGGGGGGTTCAGTTAAGATATCC
GAACAGCTCAGTACCTTGAGCCGCAGGTGT|TTACCAAGGGCTGAGAACAGCTCAAAGCAC
CAGAAAGACCCCTCCACGCGAGAAGGTTAA|AGCTACGGTTAAGGGAGTACTGGTTGGCCT
TTACCAAGGGCTGAGAACAGCTCAGGTGTG|ATTTCATCCAGAATGTTTTGATTCTGGCGT
GTCTTGTCCTAGGACTACGACGTAAGCGAT|ATTGACACAATGTGTTGAGTCTTGCCTCGA
GTAGAGATACACTGAGCGCGGGTCTCGTGA|ATCATCTGCTGGGGTGTTGATCATTCAATC
CAGAGACCTAACCCACCTCTGTATCATCTG|CTTCGATAACACTAGAGTCATGGGATTTCG
ATCAGGTTTCAGAAAGACCCCTCCACGCGA|AGTCCTTTGAGCTACGGTTAAGGGAGTACT
TGCGTGTAAATTTGTTCAGTGCATAACCTG|CTGAGAACAGCTCATTCTAGGCTTACTTAT
CAAGATTCCCAGATACTACAAGTGGAATTA|AGAACAGCTCAGTACCTTGAGCCGCAGGTG
ATACCGATCCATGAGGACGTAGAGATACAC|GACCTAACCCACCTCTGTATCATCTGCTGG
AGAACAGCTCAAAGCACGTTGTTAAGTGGA|GCCTTAACCGCAACTTTGTCATAATAATTA
TCGAAGTCCTAGACGCTATAGGGATCAGGT|ATATTTTATCATGCGCACAGGTCAGTCCTT
AGTGGAATTACCAAGGGCGTGGAATTACCA|TGCCTATTGGTACAGTCTCTAGCTATGGAA
GGGGGTTCAGTTAAGATATCCTAACTATTT|ACCGAACCTGTTCGCGCCGAGGGCGGCAAA
GAGAGGGAGTGGAATTACCAAGGGCTGAGA|ATTTGTTCAGTGCATAACCTGAGTGGAATT
GTTCAGAACCAGTAGCTGTACCCGTTCTTT|TGTGGAATTACCAAGGGCTGAGAACAGCTC
TAGAAAAGTCGACAATTTTTATCCAAGATT|GGGAGTGGAATTACCAAGGGCTGAGAACAG
CGATGGGCTGTGGAATTACCAAGGGCTGAG|ATACTACAAGTGGAATTACCAAGGGCTGAG
CCCAGATACTACAAGTGGAATTACCAAGGG|CTCAGTACCTTGAGCCGCAGGTGTCCACGG
TGTCGTCGGCATATTCGGTGGAAGGCAAAC|AGTGAACGGGTAGTACCACCACGGAAATAT
ATATCCTATTGACACAATGTGTTGAGTCTT|AGAAAAGTCGACAATTTTTATCCAAGATTC
GGAATTACCAAGGGCTGAGAACAGCTCAGA|GCAGGTGTCCACGGAAACCAGTGAAGCTTC
CCTAGAAAAGTCGACAATTTTTATCCAAGA|GAGGGAGTGGAATTACCAAGGGCTGAGAAC
AGACCCCTCCACGCGAGAAGGTTAACACGA|CGGTTAAGGGAGTACTGGTTGGCCTTCAGG
TGCGGCCTTAACCGCAACTTTGTCATAATA|GCTGAGAACAGCTCACATTCATGCTGAGGA
TGAGTGGAATTACCAAGGGCTGAGAACAGC|ATAAGAATGGTATTCAAATGCGGCCTTAAC
TCTGCTGGGGTGTTGATCATTCAATCGCGA|TTCGTCGGCACGGGGCTATTGCGTGTAAAT
GAACAGCTCAGGTGTGGGTGGAATTACCAA|GTTTTGATTCTGGCGTCGAAGTCCTAGACG
TGCGGTAGTGAACGGGTAGTACCACCACGG|GATACACTGAGCGCGGGTCTCGTGAGACTC
AACCTTGCCAAAAGCTTATGCGGTAGTGAA|GATCCATGAGGACGTAGAGATACACTGAGC
GTTCTTTGCAATATAAACCTTGCCAAAAGC|ACAGCTCATCATACCGATCCATGAGGACGT
TGGAATTACCAAGGGCTGAGAACAGCTCAA|GAATGGTATTCAAATGCGGCCTTAACCGCA
AGGGCTGAGAACAGCTCAGTACCTTGAGCC|GAGTGGAATTACCAAGGGCTGAGAACAGCT
CCCACCTCTGTATCATCTGCTGGGGTGTTG|CTAGAGTCATGGGATTTCGTCGGCACGGGG
GGCTACCGAACCTGTTCGCGCCGAGGGCGG|CGATGGAAACTCGAAAAGATGCGTATACCT
CAGCTCAAAGCACGTTGTTAAGTGGAATTA|TAACCGCAACTTTGTCATAATAATTAATTC
GAACCAGTAGCTGTACCCGTTCTTTGCAAT|AATTACCAAGGGCTGAGAACAGCTCATCAT
CAAGGGCTGAGAACAGCTCATGACTAAGCT|ACGACGTAAGCGATACACAGTTCAGAACCA
ATCCAAGATTCCCAGATACTACAAGTGGAA|CTGAGAACAGCTCAGTACCTTGAGCCGCAG
GTTGTTAAGTGGAATTACCAAGGGCTGAGA|GTCATAATAATTAATTCGCGGCCCGCTATG
ACAATTTTTATCCAAGATTCCCAGATACTA|TACCAAGGGCTGAGAACAGCTCAGTACCTT
TTGTCATAATAATTAATTCGCGGCCCGCTA|CATGCTGAGGAGGGGGGGTTCAGTTAAGAT
GGAATTGTGGGTGGAATTACCAAGGGCTGA|ACAGCTCATGAGAACAGCTCAGCTCAACCA
AAGCTACTGCCTATTGGTACAGTCTCTAGC|AACCAGTAGCTGTACCCGTTCTTTGCAATA
GTCGGCATATTCGGTGGAAGGCAAACTTTG|AACGGGTAGTACCACCACGGAAATATCCTA
CAGTTAAGATATCCTAACTATTTCATCCAG|CTGTTCGCGCCGAGGGCGGCAAAGTGTGTA
GAGAACAGTGGAATTACCAAGGGCGTGGAA|AGCTACTGCCTATTGGTACAGTCTCTAGCT
CAGGTTTCAGAAAGACCCCTCCACGCGAGA|TCCTTTGAGCTACGGTTAAGGGAGTACTGG
ATAAACCTTGCCAAAAGCTTATGCGGTAGT|ACCGATCCATGAGGACGTAGAGATACACTG
ACCTCTGTATCATCTGCTGGGGTGTTGATC|GAGTCATGGGATTTCGTCGGCACGGGGCTA
CCAGTAGCTGTACCCGTTCTTTGCAATATA|TACCAAGGGCTGAGAACAGCTCATCATACC
GACTAAGCTACTGCCTATTGGTACAGTCTC|TCAGAACCAGTAGCTGTACCCGTTCTTTGC
ATAATAATTAATTCGCGGCCCGCTATGGGT|TGAGGAGGGGGGGTTCAGTTAAGATATCCT
AACAGTGGAATTACCAAGGGCGTGGAATTA|TACTGCCTATTGGTACAGTCTCTAGCTATG
GAACAGCTCATCATACCGATCCATGAGGAC|GAACAGCTCAGAGACCTAACCCACCTCTGT
CGGGTCTCGTGAGACTCCTAGAAAAGTCGA|GATCATTCAATCGCGAGAGGGAGTGGAATT
AACAGCTCAAAGCACGTTGTTAAGTGGAAT|CTTAACCGCAACTTTGTCATAATAATTAAT
CTATGGAAATCTCACTACTCTCCGAGTTGT|ATAAACCTTGCCAAAAGCTTATGCGGTAGT
AGTTGTCGTCGGCATATTCGGTGGAAGGCA|GGTAGTGAACGGGTAGTACCACCACGGAAA
CACAGTTCAGAACCAGTAGCTGTACCCGTT|GGGCTGTGGAATTACCAAGGGCTGAGAACA
ACCAAGGGCTGAGAACAGCTCAAATTACCA|AGACGCTATAGGGATCAGGTTTCAGAAAGA
GGCTTACTTATAAGAATGGTATTCAAATGC|GGCTGAGAACAGCTCAAATTACCAAGGGCT
TGAGAACAGCTCAGGTGTGGGTGGAATTAC|AATGTTTTGATTCTGGCGTCGAAGTCCTAG
GCTGAGAACAGCTCAGTACCTTGAGCCGCA|TGGAATTACCAAGGGCTGAGAACAGCTCAA
CTAGGACTACGACGTAAGCGATACACAGTT|AATGTGTTGAGTCTTGCCTCGATGGGCTGT
GATGGGCTGTGGAATTACCAAGGGCTGAGA|TACTACAAGTGGAATTACCAAGGGCTGAGA
GAATGTTTTGATTCTGGCGTCGAAGTCCTA|ACGGCCACGAACTAATTAAATATTTTATCA
GATAGCGGCTACCGAACCTGTTCGCGCCGA|GGGGCTCGATGGAAACTCGAAAAGATGCGT
AGTCGACAATTTTTATCCAAGATTCCCAGA|GGAATTACCAAGGGCTGAGAACAGCTCAGT
CAACTTTGTCATAATAATTAATTCGCGGCC|ACATTCATGCTGAGGAGGGGGGGTTCAGTT
GAAATATCCTATTGACACAATGTGTTGAGT|CCTAGAAAAGTCGACAATTTTTATCCAAGA
CCTAACCCACCTCTGTATCATCTGCTGGGG|TAACACTAGAGTCATGGGATTTCGTCGGCA
GCTGGGGTGTTGATCATTCAATCGCGAGAG|GTCGGCACGGGGCTATTGCGTGTAAATTTG
GAGAACAGCTCAGCTGAGAACAGCTCATGA|TCGTCGGCATATTCGGTGGAAGGCAAACTT
TCTTGTCCTAGGACTACGACGTAAGCGATA|TTGACACAATGTGTTGAGTCTTGCCTCGAT
TAGGGATCAGGTTTCAGAAAGACCCCTCCA|AGGTCAGTCCTTTGAGCTACGGTTAAGGGA
CTTCTCTTACTTATGGGATGAGGTGGGAAG|AGGGTGGAATTACCAAGGGCTGAGAACAGC
CGATCCATGAGGACGTAGAGATACACTGAG|TAACCCACCTCTGTATCATCTGCTGGGGTG
GCTACCGAACCTGTTCGCGCCGAGGGCGGC|GATGGAAACTCGAAAAGATGCGTATACCTA
GTTGTCGTCGGCATATTCGGTGGAAGGCAA|GTAGTGAACGGGTAGTACCACCACGGAAAT
GCTCAAATTACCAAGGGCTGAGAACAGCTC|GGTTTCAGAAAGACCCCTCCACGCGAGAAG
CCACCACGGAAATATCCTATTGACACAATG|GTGAGACTCCTAGAAAAGTCGACAATTTTT
TCCTATTGACACAATGTGTTGAGTCTTGCC|AAAGTCGACAATTTTTATCCAAGATTCCCA
TGTCCACGGAAACCAGTGAAGCTTCGATAA|CACGTTGTTAAGTGGAATTACCAAGGGCTG
TACCAAGGGCTGAGAACAGCTCAAAGCACG|TATTCAAATGCGGCCTTAACCGCAACTTTG
AGCGCGGGTCTCGTGAGACTCCTAGAAAAG|TGTTGATCATTCAATCGCGAGAGGGAGTGG
CGAGAGGGAGTGGAATTACCAAGGGCTGAG|AATTTGTTCAGTGCATAACCTGAGTGGAAT
CTGTGGAATTACCAAGGGCTGAGAACAGCT|AAGTGGAATTACCAAGGGCTGAGAACAGCT
TAAGCGATACACAGTTCAGAACCAGTAGCT|TGCCTCGATGGGCTGTGGAATTACCAAGGG
GATACACTGAGCGCGGGTCTCGTGAGACTC|CTGCTGGGGTGTTGATCATTCAATCGCGAG
AGAACAGCTCAGGTGTGGGTGGAATTACCA|TGTTTTGATTCTGGCGTCGAAGTCCTAGAC
GCTCAAAGCACGTTGTTAAGTGGAATTACC|ACCGCAACTTTGTCATAATAATTAATTCGC
GCTGAGAACAGCTCAAATTACCAAGGGCTG|AACCAAGGGCTGAGAACAGCTCATGACTAA
CAGCTCATGACTAAGCTACTGCCTATTGGT|TACACAGTTCAGAACCAGTAGCTGTACCCG
AAGCACGTTGTTAAGTGGAATTACCAAGGG|AACTTTGTCATAATAATTAATTCGCGGCCC
GCTCATGACTAAGCTACTGCCTATTGGTAC|CACAGTTCAGAACCAGTAGCTGTACCCGTT
GGTGGGAAGTGTCTGAAGTGGAATTGTGGG|GAGAACAGCTCAGCTGAGAACAGCTCATGA
CTGAGAACAGCTCACATTCATGCTGAGGAG|TCCACGCGAGAAGGTTAACACGATAGCGGC
GTACCCGTTCTTTGCAATATAAACCTTGCC|CTGAGAACAGCTCATCATACCGATCCATGA
ACCCACCTCTGTATCATCTGCTGGGGTGTT|ACTAGAGTCATGGGATTTCGTCGGCACGGG
ACAGCTCAGTACCTTGAGCCGCAGGTGTCC|ACCAAGGGCTGAGAACAGCTCAAAGCACGT
CCAAAAGCTTATGCGGTAGTGAACGGGTAG|GAGGACGTAGAGATACACTGAGCGCGGGTC
TGAGCGCGGGTCTCGTGAGACTCCTAGAAA|GGTGTTGATCATTCAATCGCGAGAGGGAGT
TATTGACACAATGTGTTGAGTCTTGCCTCG|GTCGACAATTTTTATCCAAGATTCCCAGAT
GGCTGAGAACAGCTCAGTACCTTGAGCCGC|GTGGAATTACCAAGGGCTGAGAACAGCTCA
TGATCATTCAATCGCGAGAGGGAGTGGAAT|GGCTATTGCGTGTAAATTTGTTCAGTGCAT
TAGCTATGGAAATCTCACTACTCTCCGAGT|AATATAAACCTTGCCAAAAGCTTATGCGGT
ACCAAGGGCTGAGAACAGCTCACATTCATG|AAGACCCCTCCACGCGAGAAGGTTAACACG
GGAATTACCAAGGGTGGAATTACCAAGGGC|AGCTATGGAAATCTCACTACTCTCCGAGTT
GCTCAACCAAGGGCTGAGAACAGCTCATGA|TAGGACTACGACGTAAGCGATACACAGTTC
ACCAAGGGCTGAGAACAGCTCATCATACCG|ACCAAGGGCTGAGAACAGCTCAGAGACCTA
AGAACAGCTCATCATACCGATCCATGAGGA|AGAACAGCTCAGAGACCTAACCCACCTCTG
GTGTTGATCATTCAATCGCGAGAGGGAGTG|ACGGGGCTATTGCGTGTAAATTTGTTCAGT
TACACTGAGCGCGGGTCTCGTGAGACTCCT|GCTGGGGTGTTGATCATTCAATCGCGAGAG
CAAATTACCAAGGGCTGAGAACAGCTCACA|TTCAGAAAGACCCCTCCACGCGAGAAGGTT
CACGCGAGAAGGTTAACACGATAGCGGCTA|GAGTACTGGTTGGCCTTCAGGGGCTCGATG
TACACAGTTCAGAACCAGTAGCTGTACCCG|ATGGGCTGTGGAATTACCAAGGGCTGAGAA
TTACTTATGGGATGAGGTGGGAAGTGTCTG|GAATTACCAAGGGCTGAGAACAGCTCAGCT
ACAGTCTCTAGCTATGGAAATCTCACTACT|TTCTTTGCAATATAAACCTTGCCAAAAGCT
GTCCTAGACGCTATAGGGATCAGGTTTCAG|TTATCATGCGCACAGGTCAGTCCTTTGAGC
TCTTACTTATGGGATGAGGTGGGAAGTGTC|TGGAATTACCAAGGGCTGAGAACAGCTCAG
AGGGTGGAATTACCAAGGGCTGAGAACAGC|ATCTCACTACTCTCCGAGTTGTCGTCGGCA
TCACTACTCTCCGAGTTGTCGTCGGCATAT|CAAAAGCTTATGCGGTAGTGAACGGGTAGT
ATACACAGTTCAGAACCAGTAGCTGTACCC|GATGGGCTGTGGAATTACCAAGGGCTGAGA
GGGTAGTACCACCACGGAAATATCCTATTG|CGGGTCTCGTGAGACTCCTAGAAAAGTCGA
TCCGAGTTGTCGTCGGCATATTCGGTGGAA|ATGCGGTAGTGAACGGGTAGTACCACCACG
TTCAGTGCATAACCTGAGTGGAATTACCAA|TTCTAGGCTTACTTATAAGAATGGTATTCA
AGCGATACACAGTTCAGAACCAGTAGCTGT|CCTCGATGGGCTGTGGAATTACCAAGGGCT
CCTAACTATTTCATCCAGAATGTTTTGATT|AGGGCGGCAAAGTGTGTACGGCCACGAACT
GAACAGCTCAAAGCACGTTGTTAAGTGGAA|CCTTAACCGCAACTTTGTCATAATAATTAA
TTCCCAGATACTACAAGTGGAATTACCAAG|AGCTCAGTACCTTGAGCCGCAGGTGTCCAC
ACCCCTCCACGCGAGAAGGTTAACACGATA|GTTAAGGGAGTACTGGTTGGCCTTCAGGGG
TTACCAAGGGCTGAGAACAGCTCAGTACCT|TAACCTGAGTGGAATTACCAAGGGCTGAGA
TCATAATAATTAATTCGCGGCCCGCTATGG|GCTGAGGAGGGGGGGTTCAGTTAAGATATC
CCGCTATGGGTGGAATTACCAAGGGCTGAG|TAAGATATCCTAACTATTTCATCCAGAATG
AATCGCGAGAGGGAGTGGAATTACCAAGGG|GTGTAAATTTGTTCAGTGCATAACCTGAGT
GAATTACCAAGGGCTGAGAACAGCTCATTC|AGAACAGCTCAGGTGTGGGTGGAATTACCA
CCAAGGGTGGAATTACCAAGGGCTGAGAAC|GAAATCTCACTACTCTCCGAGTTGTCGTCG
CTTGCCTCGATGGGCTGTGGAATTACCAAG|TTCCCAGATACTACAAGTGGAATTACCAAG
AACTATTTCATCCAGAATGTTTTGATTCTG|GCGGCAAAGTGTGTACGGCCACGAACTAAT
GACTCCTAGAAAAGTCGACAATTTTTATCC|GCGAGAGGGAGTGGAATTACCAAGGGCTGA
GGAATTACCAAGGGCGTGGAATTACCAAGG|CTATTGGTACAGTCTCTAGCTATGGAAATC
GGACTACGACGTAAGCGATACACAGTTCAG|GTGTTGAGTCTTGCCTCGATGGGCTGTGGA
ATCGCGAGAGGGAGTGGAATTACCAAGGGC|TGTAAATTTGTTCAGTGCATAACCTGAGTG
TGGGTGGAATTACCAAGGGCTGAGAACAGC|ATGAGAACAGCTCAGCTCAACCAAGGGCTG
GCTCAAATTACCAAGGGCTGAGAACAGTGG|TGAGAACAGCTCATGACTAAGCTACTGCCT
GTGGAATTACCAAGGGCTGAGAACAGCTCA|CTGAGAACAGCTCAGGTGTGGGTGGAATTA
GCTCAGCTCAACCAAGGGCTGAGAACAGCT|TGTCCTAGGACTACGACGTAAGCGATACAC
ATCTGATCGTGGAATTACCAAGGGCTGAGA|ACCAAGGGCTGAGAACAGCTCAGGTGTGGG
ATTGTGGGTGGAATTACCAAGGGCTGAGAA|GCTCATGAGAACAGCTCAGCTCAACCAAGG
TCAGAACCAGTAGCTGTACCCGTTCTTTGC|TGGAATTACCAAGGGCTGAGAACAGCTCAT
AGAGGGAGTGGAATTACCAAGGGCTGAGAA|TTTGTTCAGTGCATAACCTGAGTGGAATTA
GATTCCCAGATACTACAAGTGGAATTACCA|ACAGCTCAGTACCTTGAGCCGCAGGTGTCC
TATAGGGATCAGGTTTCAGAAAGACCCCTC|ACAGGTCAGTCCTTTGAGCTACGGTTAAGG
CTCAGCTGAGAACAGCTCATGAGAACAGCT|ATATTCGGTGGAAGGCAAACTTTGTCTTGT
TCGGTGGAAGGCAAACTTTGTCTTGTCCTA|ACCACCACGGAAATATCCTATTGACACAAT
CCAAGGGCTGAGAACAGCTCAAATCTGATC|GCGGCCCGCTATGGGTGGAATTACCAAGGG
AACACTAGAGTCATGGGATTTCGTCGGCAC|TGAGAACAGCTCAAATCTGATCGTGGAATT
ACACTGAGCGCGGGTCTCGTGAGACTCCTA|CTGGGGTGTTGATCATTCAATCGCGAGAGG
ATGGGATTTCGTCGGCACGGGGCTATTGCG|AAATCTGATCGTGGAATTACCAAGGGCTGA
GAAATCTCACTACTCTCCGAGTTGTCGTCG|CCTTGCCAAAAGCTTATGCGGTAGTGAACG
ATCATTCAATCGCGAGAGGGAGTGGAATTA|CTATTGCGTGTAAATTTGTTCAGTGCATAA
CTCAAATCTGATCGTGGAATTACCAAGGGC|GAATTACCAAGGGCTGAGAACAGCTCAGGT
TACCAAGGGCTGAGAACAGCTCAAATCTGA|TCGCGGCCCGCTATGGGTGGAATTACCAAG
AACTTTGTCATAATAATTAATTCGCGGCCC|CATTCATGCTGAGGAGGGGGGGTTCAGTTA
AATTGTGGGTGGAATTACCAAGGGCTGAGA|AGCTCATGAGAACAGCTCAGCTCAACCAAG
TGGCGTCGAAGTCCTAGACGCTATAGGGAT|ATTAAATATTTTATCATGCGCACAGGTCAG
AAAAGTCGACAATTTTTATCCAAGATTCCC|AGTGGAATTACCAAGGGCTGAGAACAGCTC
AACAGCTCATCATACCGATCCATGAGGACG|AACAGCTCAGAGACCTAACCCACCTCTGTA
GCGGCTACCGAACCTGTTCGCGCCGAGGGC|CTCGATGGAAACTCGAAAAGATGCGTATAC
AGTGGAATTGTGGGTGGAATTACCAAGGGC|AGAACAGCTCATGAGAACAGCTCAGCTCAA
AAGGGCTGAGAACAGCTCAAATTACCAAGG|CGCTATAGGGATCAGGTTTCAGAAAGACCC
AGAACCAGTAGCTGTACCCGTTCTTTGCAA|GAATTACCAAGGGCTGAGAACAGCTCATCA
TCAATCGCGAGAGGGAGTGGAATTACCAAG|GCGTGTAAATTTGTTCAGTGCATAACCTGA
TGGGAAGTGTCTGAAGTGGAATTGTGGGTG|GAACAGCTCAGCTGAGAACAGCTCATGAGA
TGGTATTCAAATGCGGCCTTAACCGCAACT|AATTACCAAGGGCTGAGAACAGCTCACATT
ATTGGTACAGTCTCTAGCTATGGAAATCTC|TACCCGTTCTTTGCAATATAAACCTTGCCA
TGAGAACAGCTCAAATTACCAAGGGCTGAG|CCAAGGGCTGAGAACAGCTCATGACTAAGC
TTAAGATATCCTAACTATTTCATCCAGAAT|TTCGCGCCGAGGGCGGCAAAGTGTGTACGG
TACTTATGGGATGAGGTGGGAAGTGTCTGA|AATTACCAAGGGCTGAGAACAGCTCAGCTG
TAACCGCAACTTTGTCATAATAATTAATTC|CAGCTCACATTCATGCTGAGGAGGGGGGGT
CCCTCCACGCGAGAAGGTTAACACGATAGC|TAAGGGAGTACTGGTTGGCCTTCAGGGGCT
GTTCAGTGCATAACCTGAGTGGAATTACCA|ATTCTAGGCTTACTTATAAGAATGGTATTC
ACGTAGAGATACACTGAGCGCGGGTCTCGT|GTATCATCTGCTGGGGTGTTGATCATTCAA
CAAGGGCTGAGAACAGCTCAAAGCACGTTG|TCAAATGCGGCCTTAACCGCAACTTTGTCA
GCTCACATTCATGCTGAGGAGGGGGGGTTC|GAAGGTTAACACGATAGCGGCTACCGAACC
GGCTGAGAACAGCTCAAAGCACGTTGTTAA|ATGCGGCCTTAACCGCAACTTTGTCATAAT
GATACTACAAGTGGAATTACCAAGGGCTGA|GTACCTTGAGCCGCAGGTGTCCACGGAAAC
GAGTGGAATTACCAAGGGCTGAGAACAGCT|TCAGTGCATAACCTGAGTGGAATTACCAAG
TCTAGGCTTACTTATAAGAATGGTATTCAA|CAAGGGCTGAGAACAGCTCAAATTACCAAG
ACTAGAGTCATGGGATTTCGTCGGCACGGG|GAACAGCTCAAATCTGATCGTGGAATTACC
CTGAGAACAGCTCATGACTAAGCTACTGCC|TAAGCGATACACAGTTCAGAACCAGTAGCT
TGCATAACCTGAGTGGAATTACCAAGGGCT|GGCTTACTTATAAGAATGGTATTCAAATGC
CAGCTCAAATTACCAAGGGCTGAGAACAGC|CAGGTTTCAGAAAGACCCCTCCACGCGAGA
TGGAATTACCAAGGGCTGAGAACAGCTCAA|ATTAATTCGCGGCCCGCTATGGGTGGAATT
GGGCTGAGAACAGCTCAAATTACCAAGGGC|CTATAGGGATCAGGTTTCAGAAAGACCCCT
ATTCAAATGCGGCCTTAACCGCAACTTTGT|ACCAAGGGCTGAGAACAGCTCACATTCATG
CGTCGAAGTCCTAGACGCTATAGGGATCAG|AAATATTTTATCATGCGCACAGGTCAGTCC
ATTTCGTCGGCACGGGGCTATTGCGTGTAA|TGATCGTGGAATTACCAAGGGCTGAGAACA
CAGAATGTTTTGATTCTGGCGTCGAAGTCC|GTACGGCCACGAACTAATTAAATATTTTAT
GTGCATAACCTGAGTGGAATTACCAAGGGC|AGGCTTACTTATAAGAATGGTATTCAAATG
TAGGCTTACTTATAAGAATGGTATTCAAAT|AGGGCTGAGAACAGCTCAAATTACCAAGGG
GTGTTGAGTCTTGCCTCGATGGGCTGTGGA|TATCCAAGATTCCCAGATACTACAAGTGGA
GAAACCAGTGAAGCTTCGATAACACTAGAG|TAAGTGGAATTACCAAGGGCTGAGAACAGC
TACAGTCTCTAGCTATGGAAATCTCACTAC|GTTCTTTGCAATATAAACCTTGCCAAAAGC
ATCCAGAATGTTTTGATTCTGGCGTCGAAG|TGTGTACGGCCACGAACTAATTAAATATTT
TTATGGGATGAGGTGGGAAGTGTCTGAAGT|TACCAAGGGCTGAGAACAGCTCAGCTGAGA
CGTGGAATTACCAAGGGTGGAATTACCAAG|TCTAGCTATGGAAATCTCACTACTCTCCGA
TTCAATCGCGAGAGGGAGTGGAATTACCAA|TGCGTGTAAATTTGTTCAGTGCATAACCTG
GCGGCCCGCTATGGGTGGAATTACCAAGGG|TCAGTTAAGATATCCTAACTATTTCATCCA
AGTGTCTGAAGTGGAATTGTGGGTGGAATT|GCTCAGCTGAGAACAGCTCATGAGAACAGC
AGTTCAGAACCAGTAGCTGTACCCGTTCTT|CTGTGGAATTACCAAGGGCTGAGAACAGCT
CAAGGGCTGAGAACAGCTCAAATTACCAAG|ACGCTATAGGGATCAGGTTTCAGAAAGACC
ACGTTGTTAAGTGGAATTACCAAGGGCTGA|TTGTCATAATAATTAATTCGCGGCCCGCTA
CGGCACGGGGCTATTGCGTGTAAATTTGTT|GGAATTACCAAGGGCTGAGAACAGCTCATT
AGGTGGGAAGTGTCTGAAGTGGAATTGTGG|TGAGAACAGCTCAGCTGAGAACAGCTCATG
CAAATGCGGCCTTAACCGCAACTTTGTCAT|AAGGGCTGAGAACAGCTCACATTCATGCTG
AGGGCTGAGAACAGCTCAAAGCACGTTGTT|AAATGCGGCCTTAACCGCAACTTTGTCATA
AGAGTCATGGGATTTCGTCGGCACGGGGCT|CAGCTCAAATCTGATCGTGGAATTACCAAG
ATAACACTAGAGTCATGGGATTTCGTCGGC|GCTGAGAACAGCTCAAATCTGATCGTGGAA
GCAACTTTGTCATAATAATTAATTCGCGGC|CACATTCATGCTGAGGAGGGGGGGTTCAGT
TATCCTAACTATTTCATCCAGAATGTTTTG|CCGAGGGCGGCAAAGTGTGTACGGCCACGA
TAGCGGCTACCGAACCTGTTCGCGCCGAGG|GGCTCGATGGAAACTCGAAAAGATGCGTAT
GCGAGAAGGTTAACACGATAGCGGCTACCG|TACTGGTTGGCCTTCAGGGGCTCGATGGAA
GCTTATGCGGTAGTGAACGGGTAGTACCAC|GTAGAGATACACTGAGCGCGGGTCTCGTGA
ATAGGGATCAGGTTTCAGAAAGACCCCTCC|CAGGTCAGTCCTTTGAGCTACGGTTAAGGG
TGTGTTGAGTCTTGCCTCGATGGGCTGTGG|TTATCCAAGATTCCCAGATACTACAAGTGG
ACCAAGGGCTGAGAACAGTGGAATTACCAA|CTCATGACTAAGCTACTGCCTATTGGTACA
TGATCGTGGAATTACCAAGGGCTGAGAACA|AAGGGCTGAGAACAGCTCAGGTGTGGGTGG
TCATGCTGAGGAGGGGGGGTTCAGTTAAGA|ACACGATAGCGGCTACCGAACCTGTTCGCG
AGGGCTGAGAACAGCTCATGACTAAGCTAC|GACGTAAGCGATACACAGTTCAGAACCAGT
TACCAAGGGCTGAGAACAGCTCATCATACC|TACCAAGGGCTGAGAACAGCTCAGAGACCT
AGCCGCAGGTGTCCACGGAAACCAGTGAAG|AGCTCAAAGCACGTTGTTAAGTGGAATTAC
ATAACCTGAGTGGAATTACCAAGGGCTGAG|TTACTTATAAGAATGGTATTCAAATGCGGC
ACCAAGGGCTGAGAACAGCTCATGACTAAG|CTACGACGTAAGCGATACACAGTTCAGAAC
GACAATTTTTATCCAAGATTCCCAGATACT|TTACCAAGGGCTGAGAACAGCTCAGTACCT
CAAGGGCTGAGAACAGCTCAGCTGAGAACA|CCGAGTTGTCGTCGGCATATTCGGTGGAAG
TCTCTAGCTATGGAAATCTCACTACTCTCC|TTGCAATATAAACCTTGCCAAAAGCTTATG
CGTTGTTAAGTGGAATTACCAAGGGCTGAG|TGTCATAATAATTAATTCGCGGCCCGCTAT
GAATTACCAAGGGCTGAGAACAGCTCAGAG|CAGGTGTCCACGGAAACCAGTGAAGCTTCG
GGTTCAGTTAAGATATCCTAACTATTTCAT|GAACCTGTTCGCGCCGAGGGCGGCAAAGTG
GTGGGTGGAATTACCAAGGGCTGAGAACAG|CATGAGAACAGCTCAGCTCAACCAAGGGCT